弱点	じゃくてん-nhược điểm; điểm yếu- NHƯỢC ĐIỂM
手形	てがた-hối phiếu- THỦ HÌNH
仏像を刻む 彫る 彫刻 ちょうこく	ぶつぞうをきざむ-Khắc tượng phật 神仏 しんぶつ- PHẬT TƯỢNG KHẮC ĐIÊU ĐIÊU KHẮC
体診 診る(みる)	からだみ-chẩn đoán cơ thể- THỂ CHẨN CHẨN
係	かかり-sự chịu trách nhiện - HỆ
備え付ける	そなえつける-lắp đặt; chuẩn bị sẵn; sẵn có- BỊ PHÓ
備品	びひん-Trang thiết bị- BỊ PHẨM
再生	さいせい-tái sinh, dùng lại - TÁI SINH
割増	わりまし-tiền thưởng, tiền trả thêm - CÁT TĂNG
医寮	いりょう-chữa trị - Y LIÊU
参集者	さんしゅうしゃ-Người tụ tập- THAM/SÂM TẬP GIẢ
取り寄せる	とりよせる-Đặt hàng giao tận nơi- THỦ KỲ
取り次ぐ	とりつぐ-1. chuyển giao 2. truyền đạt; chuyển tới- THỦ THỨ
受付	うけつけ-quầy lễ tân- THỤ/THỌ PHÓ
問いただす	といただす-gạn hỏi- VẤN
夜間	やかん-thời gian buổi tối; vào buổi tuối; ban đêm- DẠ GIAN
婦人	ふじん-phụ nữ - PHỤ NHÂN
安静（な）	あんせい（な）-nghỉ ngơi, yên tĩnh - AN TĨNH
定規	じょうぎ-thước kẻ - ĐỊNH QUY/QUI
実際に	じっさいに-thật là - THỰC TẾ
常識	じょうしき-kiến thức thông thường; bình thường - THƯỜNG THỨC
御中	おんちゅう-Quí (công ty), kính thưa, kính gửi- NGỰ TRUNG
快い	こころよい-Vui vẻ, dễ chịu, dễ thương- KHOÁI
手当	てあて-chữa bệnh; trị bệnh; chữa trị- THỦ ĐƯƠNG
手段	しゅだん-1. phương pháp 2. Thủ đoạn- THỦ ĐOẠN
改正	かいせい-cải chính, chỉnh sửa - CẢI CHÍNH
日付	ひづけ-ngày tháng - NHẬT PHÓ
日月	にちげつ-Ngày tháng, năm tháng, mặt trăng và mặt trời- NHẬT NGUYỆT
映像	えいぞう-hình ảnh- ẢNH/ÁNH TƯỢNG
時刻	じこく-lúc, thời khắc - THỜI/THÌ KHẮC
時間割	じかんわり-thời gian biểu, thời gian làm việc và nghỉ ngơi- THỜI/THÌ GIAN CÁT
検問	けんもん-Thanh tra, kiểm tra- KIỂM VẤN
法令	ほうれい-luật lệ- PHÁP LỆNH
流行	りゅうこう-thịnh hành, lưu hành - LƯU HÀNH
清い	きよい-Trong suốt, tinh khiết, nguyên chất- THANH
清い流れ	きよいながれ-dòng nước trong- THANH LƯU
清算	せいさん-thanh toán- THANH TOÁN
準急	じゅんきゅう-Tàu tốc hành thường (chậm hơn tàu tốc hành)- CHUẨN CẤP
点検	てんけん-Kiểm tra, xem xét kĩ lưỡng- ĐIỂM KIỂM
為替	かわせ-hối đoái, ngân phiếu- VI THẾ
片方	かたほう-một hướng; một chiều; một chiếc; một bên- PHIẾN PHƯƠNG
特有	とくゆう-Riêng biệt, vốn có, cố hữu- ĐẶC HỮU
発する	はっする-phát nguồn; khởi nguồn; bắt nguồn- PHÁT
相違	そうい-sự khác nhau- TƯƠNG/TƯỚNG VI
磁石	じしゃく-nam châm - TỪ THẠCH
立て札 改札口	たてふだ/ かいさつぐち-bảng thông báo/ cổng soát vé- LẬP TRÁT CẢI TRÁT KHẨU
符号 寄付 切符	ふごう/きふ/ きっぷ-Ký hiệu, nhãn hiệu/đóng góp/vé- PHÙ HIỆU KỲ PHÓ THIẾT PHÙ
第～	だい～-thứ ～ (thứ 1, thứ 2, v.v...)- ĐỆ
緊急 緊張 大臣	きんきゅう-Khẩn cấp- KHẨN CẤP KHẨN TRƯƠNG ĐẠI THẦN
線路	せんろ-đường ray, đường sắt - TUYẾN LỘ
縄 滝(たき) 綿(めん/わた) 紐（ひも）	なわ-dây thừng/ thác nước/sợi bông; vải bông; bông; cotton- THẰNG LANG MIÊN
縄を解く 溶ける(とける) 解く ほどく 結ぶ	なわをとく/ほどく-Mở dây thừng- THẰNG GIẢI DUNG/DONG GIẢI KẾT
羽 溺れる(おぼれる)	はね-cánh; lông vũ/ chết đuối; chìm đắm- VŨ NỊCH
羽根 大根(だいこん)	はね-Cánh, lông vũ- VŨ CĂN ĐẠI CĂN
羽毛	うもう-Lông vũ- VŨ MAO
落第	らくだい-Thất bại, thi trượt- LẠC ĐỆ
視聴者 聴解	しちょうしゃ-Khán thính giả- THỊ THÍNH GIẢ THÍNH GIẢI
計算 引き算	けいさん-tính, tính toán - KẾ TOÁN DẪN TOÁN
設置 設定 設ける(もうける)	せっち-Bố trí, sắp đặt- THIẾT TRÍ THIẾT ĐỊNH THIẾT
議論	ぎろん-thảo luận, tranh luận - NGHỊ LUẬN
貨幣	かへい-tiền, tiền tệ- HÓA TỆ
賃金 賃貸(ちんたい)	ちんぎん-Tiền công/ sự cho thuê- NHẪM KIM NHẪM THẢI
転がる	ころがる-lăn; ngã; sụp đổ; đổ nhào- CHUYỂN
転落	てんらく-rớt xuống, giáng chức- CHUYỂN LẠC
適合 適当 指摘(してき)	てきごう-thích hợp- THÍCH HỢP/CÁP THÍCH ĐƯƠNG CHỈ TRÍCH
郵便 垂らす(たらす)	ゆうびん-dịch vụ bưu điện- BƯU TIỆN THÙY
郵送	ゆうそう-thư từ, thư tín - BƯU TỐNG
金銭	きんせん-tiền bạc- KIM TIỀN
開放 妨げる(さまたげる)	かいほう-Sự khai trương, Mở, để mở, cho mở- KHAI PHÓNG PHƯƠNG
関わる	かかわる-liên quan, về - QUAN
険しい 試験 危険	けわしい-Dốc, hiểm trở, khắc nghiệt- HIỂM THÍ NGHIỆM NGUY HIỂM
集会	しゅうかい-mitting- TẬP HỘI
黒板 坂(さか)	こくばん-bảng đen- HẮC BẢN/BẢNG PHẢN
（～に）関する	（～に）かんする-về～, liên quan～- QUAN
～の際	～のさい-khi～, lúc～- TẾ
～付き	～つき-Với～- PHÓ
～側	～がわ-bên, phía bên- TRẮC
～内	～うち-trong ～- NỘI
～化	～か-～ hóa (biến đổi từ một cái gì đó sang cái khác)- HÓA
～号車	～ごうしゃ-toa xe số ~ - HIỆU XA
～点	～てん-～ điểm - ĐIỂM
～番線	～ばんせん -tuyến số ~ - PHIÊN TUYẾN
～階	～かい-tầng ～- GIAI
１万円札 立札	１まんえんさつ-tờ tiền 1 vạn yên- VẠN VIÊN TRÁT LẬP TRÁT
ターミナル	ターミナル_terminal-bãi đỗ tàu xe; điểm cuối cùng của tàu xe-
トイレットペーパー	トイレットペーパー-Giấy vệ sinh-
トイレペーパー	トイレペーパー-giấy vệ sinh-
ベストセラー	ベストセラー-sự bán chạy nhất-
一段と	いちだんと-(phó từ) hơn rất nhiều, hơn một bậc- NHẤT ĐOẠN
下線 アンダーライン	かせん-gạch chân- HẠ TUYẾN
下降 降りる	かこう-Giảm xuống, sa sút, rơi xuống- HẠ GIÁNG/HÀNG GIÁNG/HÀNG
不思議（な）	ふしぎ（な）-huyền diệu, kỳ ảo - BẤT TƯ NGHỊ
不自由（な）	ふじゆう（な）-không tự do, bị tàn phế - BẤT TỰ DO
両～	りょう～-cả hai ~ - LƯỠNG/LƯỢNG
両側 側面	りょうがわ-hai bên - LƯỠNG/LƯỢNG TRẮC TRẮC DIỆN
両方	りょうほう-hai hướng, hai bên - LƯỠNG/LƯỢNG PHƯƠNG
両替	りょうがえ-đổi tiền - LƯỠNG/LƯỢNG THẾ
両目	りょうめ-đôi mắt ~ - LƯỠNG/LƯỢNG MỤC
両親	りょうしん-cha mẹ, bố mẹ - LƯỠNG/LƯỢNG THÂN
主婦 主に	しゅふ-vợ - CHỦ PHỤ CHỦ
仏像 印象 画像 神仏 しんぶつ	ぶつぞう-Tượng phật- PHẬT TƯỢNG ẤN TƯỢNG HỌA/HOẠCH TƯỢNG THẦN PHẬT
付近 切符	ふきん-Phụ cận,vùng lân cận- PHÓ CẬN THIẾT PHÙ
以内	いない-trong vòng - DĨ NỘI
会議室	かいぎしつ-phòng họp, phòng hội nghị - HỘI NGHỊ THẤT
係員	かかりいん-người chịu trách nhiệm- HỆ VIÊN
信号	しんごう-đèn giao thông- TÍN HIỆU
側面 側(かわ/そば)	そくめん-Mặt bên, sườn, phía cạnh- TRẮC DIỆN TRẮC TRẮC
備える	そなえる-chuẩn bị, đề phòng- BỊ
優しい	やさしい-hiền dịu, dịu dàng - ƯU
優れる	すぐれる-xuất sắc - ƯU
優先 優しい 優れる	ゆうせん-ưu tiên- ƯU TIÊN ƯU ƯU
内	うち-trong, bên trong- NỘI
内科 外科	ないか-khoa nội - NỘI KHOA NGOẠI KHOA
再び	ふたたび-lại, lần nữa - TÁI
再来年	さらいねん-năm sau nữa, hai năm nữa - TÁI LAI NIÊN
再診 診る(みる) 初診(しょしん)	さいしん-tái khám, khám lần sau- TÁI CHẨN CHẨN SƠ CHẨN
出席 出欠(しゅっけつ) 欠席 度	しゅっせき-có mặt, tham dự - XUẤT TỊCH XUẤT KHIẾM KHIẾM TỊCH ĐỘ
分割 割く(さく)	ぶんかつ-phân cắt, chia - PHÂN CÁT CÁT
分店	ぶんてん-cửa hàng chi nhánh- PHÂN ĐIẾM
切符	きっぷ-vé - THIẾT PHÙ
初	はつ/しょ-(Hậu tố) từ, xuất phát từ- SƠ
初めて	はじめて-lần đầu tiên - SƠ
初恋	はつこい-mối tình đầu - SƠ LUYẾN
初診	しょしん-khám bệnh bước đầu, khám lần đầu- SƠ CHẨN
初雪	はつゆき-đợt tuyết đầu tiên (của mùa) - SƠ TUYẾT
刻む 彫る(ほる) 彫刻(ちょうこく)	きざむ-1. đục, chạm 2. thái ( rau, quả )- KHẮC ĐIÊU ĐIÊU KHẮC
割り増し	わりまし-sự tăng thêm (theo một tỷ lệ nào đó)- CÁT TĂNG
割れる 割く(さく)	われる-vỡ, bể - CÁT CÁT
割引 割合 引き出す 弓 (ゆみ Cái cung)	わりびき-giảm giá - CÁT DẪN CÁT HỢP/CÁP DẪN XUẤT CUNG
勝敗 敗れる(やぶれる)	しょうはい-thắng bại- THẮNG BẠI BẠI
包む 小包(こづつみ)	つつむ-gói vào, bọc vào - BAO TIỂU BAO
包帯	ほうたい-Băng, đồ băng bó- BAO ĐỚI/ĐÁI
化学	かがく-hóa học - HÓA HỌC
化粧室 花粉症	けしょうしつ-phòng trang điểm - HÓA TRANG THẤT HOA PHẤN CHỨNG
危うい	あやうい-nguy hiểm- NGUY
危ない	あぶない-nguy hiểm - NGUY
危機	きき-Nguy cơ,mối hiểm hoạ- NGUY CƠ/KY
危険（な） 試験	きけん（な）-nguy hiểm - NGUY HIỂM THÍ NGHIỆM
友達	ともだち-bạn bè - HỮU ĐẠT
受ける	うける-1. tham dự (thi) 2. tiếp thu, nhận - THỤ/THỌ
受験	じゅけん-dự thi, tham gia kỳ thi- THỤ/THỌ NGHIỆM
同窓会	どうそうかい-Hội cựu sinh viên- ĐỒNG SONG HỘI
喫煙所 契約(けいやく hd)	きつえんじょ-chỗ hút thuốc, nơi hút thuốc- KHIẾT YÊN SỞ KHẾ/KHIẾT ƯỚC
喫茶店	きっさてん-quán cà phê- KHIẾT TRÀ ĐIẾM
営業 営む いとなむ	えいぎょう-kinh doanh, bán hàng - DOANH/DINH NGHIỆP DOANH/DINH
四捨五入 磁石 捨てる	ししゃごにゅう-Làm tròn- TỨ SẢ NGŨ NHẬP TỪ THẠCH SẢ
国際	こくさい-quốc tế - QUỐC TẾ
地下鉄	ちかてつ-tàu điện ngầm, xe điện ngầm- ĐỊA HẠ THIẾT
地点	ちてん-Địa điểm- ĐỊA ĐIỂM
増える	ふえる-tăng lên - TĂNG
増加 増減(ぞうげん)	ぞうか-gia tăng - TĂNG GIA TĂNG GIẢM
外科	げか-khoa ngoại - NGOẠI KHOA
妊娠 妊婦(にんぷ) 振り返る	にんしん-có thai; có chửa- NHÂM THẦN NHÂM PHỤ CHẤN PHẢN
妊婦 夫婦(ふうふ)	にんぷ-Người mang thai- NHÂM PHỤ PHU PHỤ
定休日	ていきゅうび-ngày nghỉ thường kì - ĐỊNH HƯU NHẬT
定員	ていいん-sức chứa - ĐỊNH VIÊN
定食 定める(さだめる)	ていしょく-suất ăn - ĐỊNH THỰC ĐỊNH
家賃	やちん-tiền nhà, tiền thu nhà - GIA NHẪM
寄せる	よせる-kéo lại, đặt bên cạnh, cộng, tập trung lại - KỲ
寄付	きふ-Đóng góp, quyên góp- KỲ PHÓ
小包	こづつみ-bưu kiện nhỏ - TIỂU BAO
席	せき-chỗ ngồi - TỊCH
常に	つねに-(phó từ) thường thường, luôn - THƯỜNG
年寄り 老人(ろうじん) 老ける(ふける)	としより-người già, người có tuổi - NIÊN KỲ LÃO NHÂN LÃO
座る	すわる-ngồi, ngồi xuống - TỌA
座席	ざせき-chỗ ngồi - TỌA TỊCH
引き算	ひきざん-phép trừ - DẪN TOÁN
御家族	ごかぞく-gia đình (bạn)- NGỰ GIA TỘC
御手洗い	おてあらい-toa - lét, nhà vệ sinh- NGỰ THỦ TẨY
快速	かいそく-Tốc độ cao, nhanh chóng- KHOÁI TỐC
急病	きゅうびょう-bệnh cấp tính; bạo bệnh- CẤP BỆNH
成る	なる-Trở nên,trở thành,lớn lên- THÀNH
成人式	せいじんしき-Lễ Thành Nhân- THÀNH NHÂN THỨC
成分 成果 果たす(はたす)	せいぶん-thành phần- THÀNH PHÂN THÀNH QUẢ QUẢ
押さえる	おさえる-giữ, bắt giữ- ÁP
押し入れ	おしいれ-tủ âm tường- ÁP NHẬP
押す	おす-ấn, nhấn, bấm - ÁP
指定席	していせき-ghế chỉ định - CHỈ ĐỊNH TỊCH
捨てる 四捨五入 拾う(ひろう)	すてる-từ bỏ, vứt- SẢ TỨ SẢ NGŨ NHẬP THẬP
掃く 清掃(せいそう)	はく-quét, chải - TẢO THANH TẢO
改まる	あらたまる-cải biến, sửa đổi - CẢI
改める	あらためる-sửa đổi, cải thiện - CẢI
改札口 改善(かいぜん)	かいさつぐち-cổng soát vé - CẢI TRÁT KHẨU CẢI THIỆN
放す	はなす-buông tay, rời tay- PHÓNG
放送	ほうそう-phát thanh, loan truyền - PHÓNG TỐNG
放送局	ほうそうきょく-đài truyền hình, đài phát thanh- PHÓNG TỐNG CỤC
救う 防ぐ(ふせぐ)	すくう-cứu giúp, giúp đỡ - CỨU PHÒNG
救急 救う 求人 求める	きゅうきゅう-Cấp cứu, khẩn cấp- CỨU CẤP CỨU CẦU NHÂN CẦU
文化 異文化 異なる	ぶんか-văn hóa - VĂN HÓA DỊ VĂN HÓA DỊ
新幹線	しんかんせん-tàu siêu tốc - TÂN CÁN TUYẾN
日常	にちじょう-ngày thường, thường ngày - NHẬT THƯỜNG
早速	さっそく-Ngay tức khắc, ngay lập tức- TẢO TỐC
時速	じそく-tốc độ tính theo giờ - THỜI/THÌ TỐC
札	さつ-Thẻ, tờ, tiền giấy- TRÁT
来訪 訪ねる(たずねる)	らいほう-đến thăm- LAI PHỎNG/PHÓNG PHỎNG/PHÓNG
来訪者	らいほうしゃ-Khách đến thăm- LAI PHỎNG/PHÓNG GIẢ
板	いた-tấm ván; bảng- BẢN/BẢNG
案	あん-Kế hoạch, đề án, ý kiến- ÁN
案内	あんない-hướng dẫn, chỉ dẫn - ÁN NỘI
案内板 黒板(こくばん) 板	あんないばん-bảng hướng dẫn- ÁN NỘI BẢN/BẢNG HẮC BẢN/BẢNG BẢN/BẢNG
標準 表(ひょう/おもて)	ひょうじゅん-tiêu chuẩn; hạn mức- PHIẾU CHUẨN BIỂU
欠点 欠ける(かける)	けってん-khuyết điểm - KHIẾM ĐIỂM KHIẾM
段	だん-giai đoạn - ĐOẠN
段階 皆(みんな) 比べる 比較(ひかく)	だんかい-giai đoạn - ĐOẠN GIAI GIAI TỶ/TỈ/BỈ TỶ/TỈ/BỈ GIÁC/HIỆU
水泳 凍える(こごえる)	すいえい-việc bơi, bơi- THỦY VỊNH ĐÔNG
水準	すいじゅん-Tiêu chuẩn, mức, trình độ- THỦY CHUẨN
治療 治める(おさめる) 寮(りょう)	ちりょう-điều trị - TRỊ LIỆU TRỊ LIÊU
泳ぐ	およぐ-bơi, bơi lội- VỊNH
洋食	ようしょく-đồ ăn Tây- DƯƠNG THỰC
流す	ながす-cho chảy, cho chảy đi- LƯU
流れる	ながれる-chảy, tôi chảy - LƯU
深い 欲深い(よくふかい) 欲しい 谷(たに) 容器(ようき)	ふかい-dày, sâu - THÂM DỤC THÂM DỤC CỐC DUNG/DONG KHÍ
深刻（な） 彫刻	しんこく（な）-Trầm trọng, nghiêm trọng- THÂM KHẮC ĐIÊU KHẮC
深夜 徹夜(てつや) 撒く(まく) 深刻	しんや-Nửa đêm, đêm khuya- THÂM DẠ TRIỆT DẠ TÁT THÂM KHẮC
清掃 清い(きよい)	せいそう-Quét dọn, dọn dẹp- THANH TẢO THANH
清書	せいしょ-bản copy sạch - THANH THƯ
清流	せいりゅう-dòng nước trong- THANH LƯU
温暖化 絞る	おんだんか-sự nóng lên toàn cầu - ÔN NOÃN HÓA GIẢO
港 涙 戻す	みなと-cảng - CẢNG LỆ LỆ
準備	じゅんび-chuẩn bị - CHUẨN BỊ
準決勝 決勝戦 (chung ket)	じゅんけっしょう-trận bán kết - CHUẨN QUYẾT THẮNG QUYẾT THẮNG CHIẾN
点	てん-điểm - ĐIỂM
煙 煙い(けむい) 煙たい(けむたい)	けむり-khói - YÊN YÊN YÊN
理由 料理 軽油 自由	りゆう-lý do - LÝ DO LIỆU LÝ KHINH DU TỰ DO
産婦人科	さんふじんか-khoa sản, khoa phụ sản - SẢN PHỤ NHÂN KHOA
番号	ばんごう-số hiệu - PHIÊN HIỆU
異常	いじょう-không bình thường; dị thường- DỊ THƯỜNG
疑わしい 疑問	うたがわしい-nghi ngờ; đáng ngờ; đáng nghi- NGHI NGHI VẤN
発行	はっこう-phát hành- PHÁT HÀNH
発達	はったつ-phát triển - PHÁT ĐẠT
皮	かわ-da, vỏ - BÌ
皮肉	ひにく-Mỉa mai, châm biếm- BÌ NHỤC
皮膚	ひふ-Da,vỏ- BÌ PHU
皮膚科	ひふか-khoa da liễu- BÌ PHU KHOA
看板	かんばん-Bảng, bảng hiệu- KHÁN BẢN/BẢNG
看病	かんびょう-Chăm sóc, trông nom- KHÁN BỆNH
看護し 看病	かんごし-y tá- KHÁN HỘ KHÁN BỆNH
着替える 着く(つく)	きがえる-thay quần áo - TRƯỚC THẾ TRƯỚC
石	いし-đá, hòn đá - THẠCH
石段	いしだん-cầu thang đá- THẠCH ĐOẠN
社内	しゃない-trong công ty- XÃ NỘI
禁止 森林(しんりん-Rừng)	きんし-cấm, nghiêm cấm - CẤM CHỈ SÂM LÂM
禁煙 煙い 煙たい	きんえん-cấm hút thuốc - CẤM YÊN YÊN YÊN
私鉄	してつ-đường sắt tư nhân, đường sắt tư doanh- TƯ THIẾT
科学	かがく-khoa học - KHOA HỌC
空港	くうこう-sân bay - KHÔNG/KHỐNG CẢNG
窓	まど-cửa sổ - SONG
窓口	まどぐち-cửa bán vé - SONG KHẨU
立ち入り禁止	たちいりきんし-đi vào, xâm phạm, can thiệp- LẬP NHẬP CẤM CHỈ
立ち寄る	たちよる-Ghé qua, ghé ngang- LẬP KỲ
精神 神仏 仏(ほとけ)	せいしん-Tâm trí, tâm hồn, tinh thần- TINH THẦN THẦN PHẬT PHẬT
精算	せいさん-tính toán chính xác - TINH TOÁN
経由 軽油 Dầu nhẹ	けいゆ-Qua con đường, quá cảnh, sự thông qua ( thủ tục )- KINH DO KHINH DU
総合病院	そうごうびょういん-bệnh viện tổng hợp- TỔNG HỢP/CÁP BỆNH VIỆN
総計	そうけい-Tổng cộng, tổng số- TỔNG KẾ
落ちる	おちる-rơi, rụng - LẠC
落とす	おとす-đánh rơi, đánh rớt - LẠC
落石	らくせき-đá lở, đá lăn xuống- LẠC THẠCH
薬局	やっきょく-hiệu thuốc - DƯỢC CỤC
診察	しんさつ-Khám bệnh- CHẨN SÁT
診療 診る	しんりょう-khám chữa bệnh, chữa trị- CHẨN LIỆU CHẨN
議員	ぎいん-nghị viện- NGHỊ VIÊN
貯金	ちょきん-gửi tiền vào ngân hàng - TRỮ KIM
足し算	たしざん -phép tính cộng - TÚC TOÁN
通路	つうろ-hành lang, lối đi- THÔNG LỘ
速い 早速	はやい-nhanh chóng - TỐC TẢO TỐC
速達	そくたつ-chuyển phát nhanh - TỐC ĐẠT
遊ぶ	あそぶ-chơi, vui chơi - DU
遊泳 水泳 睡眠	ゆうえい-bơi- DU VỊNH THỦY VỊNH THỤY MIÊN
運賃	うんちん-Cước chuyên chở, tiền xe tàu- VẬN NHẪM
道路	どうろ-con đường - ĐẠO LỘ
郵便局	ゆうびんきょく-bưu điện - BƯU TIỆN CỤC
銀行口座	ぎんこうこうざ-tài khoản ngân hàng - NGÂN HÀNH KHẨU TỌA
閉じる	とじる-gấp, đóng (sách )- BẾ
閉まる	しまる-đóng, bị đóng chặt - BẾ
閉める	しめる-đóng - BẾ
閉会	へいかい-bế mạc hội nghị - BẾ HỘI
閉店	へいてん-đóng cửa hàng - BẾ ĐIẾM
閉店セール	へいてんセール-chấm dứt giảm giá- BẾ ĐIẾM
開放厳禁	かいほうげんきん-Cấm mở cửa- KHAI PHÓNG NGHIÊM CẤM
関係	かんけい-quan hệ - QUAN HỆ
関心	かんしん-quan tâm - QUAN TÂM
降りる	おりる-xuống ( xe, núi )- GIÁNG/HÀNG
降る	ふる-rơi (mưa ), đổ (mưa)- GIÁNG/HÀNG
降車口	こうしゃぐち-Cửa dành để xuống xe- GIÁNG/HÀNG XA KHẨU
階段	かいだん-cầu thang- GIAI ĐOẠN
静か(な)	しずか（な）-yên lặng - TĨNH
静まる	しずまる-lắng xuống, dịu đi- TĨNH
非～	ひ～-không～- PHI
非常に	ひじょうに-rất, cực kỳ - PHI THƯỜNG
非常口	ひじょうぐち-cửa thoát hiểm - PHI THƯỜNG KHẨU
音声	おんせい-âm thanh- ÂM THANH
飛び出す	とびだす-chạy ra, nhảy ra- PHI XUẤT
飛ぶ 飛び込む	とぶ-bay, nhảy - PHI PHI (nhập)
飛行場	ひこうじょう-sân bay, phi trường - PHI HÀNH TRƯỜNG
駐車	ちゅうしゃ-sự đỗ xe - TRÚ XA
駐車場	ちゅうしゃじょう-bãi đỗ xe, bãi đậu xe - TRÚ XA TRƯỜNG
完備	かんび-Trang bị đầy đủ-HÒAN BỊ
整備	せいび-Duy trì, bảo quản, sửa chữa-CHỈNH BỊ
調整	ちょうせい-điều chỉnh -ĐiỀU, ĐiỆU CHỈNH
保つ	たもつ-Duy trì, bảo quản-BẢO
小児科	しょうにか-Khoa nhi-TIỂU NHI KHOA
換気	かんき-Thông gió, thông khí-HÓAN KHÍ
損害	そんがい-Thiệt hại-TỔN HẠI
未満	みまん-Ít hơn-VỊ, MÙI MÃN
法令	ほうれい-luật lệ; pháp lệnh, sắc lệnh-PHÁP LỆNH
満ちる	みちる-kết thúc; hết thời hạn-MÃN
災害	さいがい-Tai hoạ, tai ương-TAI HẠI
生存	せいぞん-Sinh tồn, sự sống-SINH TỒN
疾病	しっぺい-Bệnh tật-TẬT BỆNH
短編	たんぺん-(truyện, tiểu thuyết) ngắn -ĐỎAN BIÊN
補償	ほしょう-Bồi thường, đền bù-BỔ THƯỜNG
賛美	さんび-tán dương; ca tụng-TOAN MỸ
～巻	～かん-quấn ~ -QUYỂN
～未満	～みまん-không đủ～, không đầy ～-VỊ, MÙI MÃN
～済み	～ずみ-hoàn tất ~ -TẾ
交通機関	こうつうきかん-Hệ thống giao thông, phương tiện giao thông-GIAO THÔNG CƠ QUAN
件名	けんめい-tiêu đề -KIỆN DANH
修了	しゅうりょう-hoàn thành (khóa học)-TU LIỄU
修士	しゅうし-thạc sĩ -TU SĨ
修正	しゅうせい-Sửa đổi, đổi lại-TU CHÍNH
修理	しゅうり-chỉnh lý, sửa chữa -TU LÝ
停止	ていし-đình chỉ, dừng lại -ĐÌNH CHỈ
冷ます	さます-làm lạnh, làm nguội -LÃNH
冷やす	ひやす-làm lạnh đi -LÃNH
冷静	れいせい-Bình tĩnh, điềm tĩnh-LÃNH TĨNH
出来事	できごと-Biến cố, sự kiện-XUẤT LAI SỰ
分量	ぶんりょう-liều lượng, phân lượng-PHÂN LƯỢNG
印	いん-cái dấu -ẤN
印	しるし-Dấu hiệu, kí hiệu-ẤN
取材	しゅざい-Thu thập dữ liệu-THỦ TÀI
団地	だんち-Khu liên hợp nhà ở, khu chung cư-ĐÒAN ĐỊA
地帯	ちたい-Vùng, khu vực-ĐỊA ĐỚI, ĐÁI
変換	へんかん-sự biến đổi, hoán chuyển -BiẾN HÓAN
完了	かんりょう-kết thúc -HÒAN LIỄU
屋内	おくない-Trong phòng-ỐC NỘI
山登り	やまのぼり-leo núi -SƠN ĐĂNG
巻く	まく-Cuộn lại, bọc lại-QUYỂN
帯	おび-đai, dây thắt lưng -ĐỚI, ĐÁI
年老いた	としおいた-Tuổi già-NIÊN LÃO
幼い	おさない-Non dại-ẤU
幼児	ようじ-Đứa bé, đứa trẻ-ẤU NHI
支払機	しはらいき-máy thanh toán tiền -CHI PHẤT CƠ
支持	"しじ-1. Duy trì 2. Ủng hộ, hậu thuẫn-CHI TRÌ"
整理券	せいりけん-số vé (vé chỉnh sửa )-CHỈNH LÝ KHÓAN
書留	かきとめ-gửi đảm bảo -THƯ LƯU
未～	み～-chưa ～-VỊ, MÙI
未知	みち-Chưa biết, xa lạ-VỊ, MÙI TRI, TRÍ
検討	けんとう-Thẩm tra, xem xét kĩ lưỡng-KIỂM THẢO
標本	ひょうほん-Mẫu-TIÊU BẢN
標準	ひょうじゅん-Tiêu chuẩn-TIÊU CHUẨN
浮かぶ	"うかぶ-1. trôi nổi; nổi lên,2. thoáng qua (trong đầu)-PHÙ"
浮かべる	"うかべる-1. thả trôi; làm nổi lên 2. mường tượng-PHÙ"
消える	きえる-tắt (điện, tivi)-TIÊU
湿気	しっけ-hơi ẩm, không khí ẩm thấp-THẤP KHÍ
満たす	みたす-Trút đầy, làm đầy, đổ đầy-MÃN
満員	まんいん-đầy người, đông người -MÃN VIÊN
満足	まんぞく-thỏa mãn, hài lòng -MÃN TÚC
照明	"しょうめい-1. ánh sáng; đèn 2. chiếu sáng-CHIẾU MINH"
片～	かた～-~ một chiều -PHIẾN
用件	ようけん-việc -DỤNG KIỆN
留守番電話	るすばんでんわ-Máy trả lời tự động-LƯU THỦ, THÚ PHIÊN ĐiỆN THOẠI
発券	はっけん-Phát hành trái phiếu-PHÁT KHÓAN
登場	とうじょう-xuất hiện (sân khấu), ra (sân khấu)-ĐĂNG TRƯỜNG, TRÀNG
登山	とざん-leo núi -ĐĂNG SƠN
目印	めじるし-dấu hiệu, mốc-MỤC ẤN
目当て	めあて-Mục đích, mục tiêu-MỤC ĐANG, ĐƯƠNG
目標	もくひょう-mục tiêu -MỤC TIÊU
示す	しめす-xuất trình, đưa cho xem-THỊ
編集	へんしゅう-biên tập-BIÊN TẬP
肯定	こうてい-khẳng định-KHẲNG ĐỊNH
表現	ひょうげん-biểu hiện -BIỂU HIỆN
規定	きてい-quy định, quy tắc -QUI ĐỊNH
設備	せつび-thiết bị, trang thiết bị -THIẾT BỊ
調子	ちょうし-tình trạng -ĐiỀU, ĐiỆU TỬ, TÝ
賛成	さんせい-tán thành-TOAN THÀNH
返却	へんきゃく-Trả lại, hoàn trả-PHẢN KHƯỚC
通信	つうしん-tuyền thông, thông tin-THÔNG TÍN
通貨	つうか-Tiền tệ-THÔNG HÓA
違法	いほう-Trái phép, phạm luật-VI(VĨ) PHÁP
鈍い	"にぶい-1. cùn 2. chậm-ĐỘN"
鋭い	するどい-sắc bén-NHUỆ
長編	ちょうへん-(truyện, tiểu thuyết) dài -TRƯỜNG, TRƯỞNG BIÊN
除湿	じょしつ-Khử ẩm-TRỪ THẤP
風向	ふうこう-Hướng gió-PHONG HƯỚNG
～倍	～ばい-gấp～-BỘI
～枚	～まい-~ tờ (đếm thư, giấy, tem )-MAI
～歳	～さい-～ tuổi -TUẾ
お守り	おまもり-lá bùa-THỦ, THÚ
ごみ箱	ごみばこ-thùng rác -SƯƠNG, TƯƠNG
ご存知	ごぞんじ-biết, hiểu, hiểu biết -TỒN TRI, TRÍ
セーブ	セーブ-Save-
一般	いっぱん-cái chung-NHẤT BAN
中央	ちゅうおう-trung ương -TRUNG, TRÚNG ƯƠNG
乗り換え	のりかえ-việc đổi xe-THỪA, THẶNG HÓAN
乗車券	じょうしゃけん-vé xe, vé hành khách -THỪA, THẶNG XA KHÓAN
予備	"よび-dự bị Đồ dự phòng-DƯ BỊ"
予定	よてい-dự định -DƯ ĐỊNH
予算	"よさん-dự toán Ngân sách, ngân quỹ-DƯ TOÁN"
予約	よやく-đặt trước, hẹn trước -DƯ ƯỚC
予習	よしゅう-soạn bài -DƯ TẬP
事件	じけん-Sự kiện, vụ việc-SỰ KIỆN
二十歳	はたち-20 tuổi -NHỊ THẬP TUẾ
人類	じんるい-Nhân loại-NHÂN LOẠI
伝える	つたえる-truyền đạt, truyền lại -TRUYỀN, TRUYỆN
伝言	でんごん-tin nhắn -TRUYỀN, TRUYỆN NGÔN
体温計	たいおんけい-Nhiệt kế-THỂ ÔN KẾ
保存	ほぞん-bảo tồn -BẢO TỒN
保守的	ほしゅてき-Bảo thủ-BẢO THỦ, THÚ ĐÍCH
保温	ほおん-giữ nhiệt, giữ độ ấm -BẢO ÔN
保湿	ほしつ-Duy trì độ ẩm-BẢO THẤP
保留	ほりゅう -bảo lưu, hoãn lại -BẢO LƯU
保険	ほけん-Bảo hiểm, cam đoan-BẢO HiỂM
信じる	しんじる-tin tưởng, tin vào -TÍN
倍	ばい-gấp đôi-BỘI
停留所	ていりゅうじょ-bến đỗ xe buýt -ĐÌNH LƯU SỞ
停車	ていしゃ-Dừng xe-ĐÌNH XA
停電	ていでん-Cúp điện-ĐÌNH ĐiỆN
児童	じどう-Đứa bé, nhi đồng, thiếu nhi-NHI ĐỒNG
入学式	にゅうがくしき-lễ nhập học-NHẬP HỌC THỨC
全般	ぜんぱん-tổng quát, toàn bộ -TÒAN BAN
公式	こうしき-Công thức-CÔNG THỨC
冷える	ひえる-lạnh đi, nguội đi -LÃNH
冷たい	つめたい-lạnh, lạnh giá -LÃNH
冷める	さめる-lạnh đi, nguội đi -LÃNH
分店	ぶんてん-Cửa hàng chi nhánh-PHÂN ĐiẾM
分類	ぶんるい-phân loại -PHÂN LOẠI
十円玉	じゅうえんだま-đồng tiền xu có trị giá 10 yên -THẬP VIÊN NGỌC
印刷	いんさつ-In ấn-ẤN LOÁT
危機	きき-Nguy cơ, mối hiểm hoạ-NGUY CƠ
反する	はんする-trái lại; ngược nhau; đối nhau-PHẢN
反対	はんたい-ngược lại-PHẢN ĐỐI
取り消し	とりけし-loại bỏ -THỦ TIÊU
取る	とる-lấy, cầm nắm-THỦ
受信箱	じゅしんばこ-hộp thư đến -THỤ TÍN SƯƠNG, TƯƠNG
口紅	くちべに-son môi -KHẨU HỒNG
可能（な）	かのう（な）-khả năng -KHẢ NĂNG
向かい	むかい-hướng tới, đối diện với -HƯỚNG
向こう	むこう-phía trước -HƯỚNG
否定	ひてい-phủ định-PHỦ ĐỊNH
回復	かいふく-phục hồi -HỒI PHỤC
回数券	かいすうけん-tập vé, quấn sổ vé -HỒI SỐ KHÓAN
団体	だんたい-đoàn thể, tập thể -ĐÒAN THỂ
基準	きじゅん-Tiêu chuẩn, nền tảng-CƠ CHUẨN
変える	かえる-đổi -BiẾN
変わる	かわる-thay đổi -BiẾN
大変（な）	たいへん（な）-vất vả, rất -ĐẠI BiẾN
存在	そんざい-tồn tại -TỒN TẠI
守る	まもる-tuân theo, gữ gìn -THỦ, THÚ
完成	かんせい-hoàn thành -HÒAN THÀNH
定期	ていき-định kì -ĐỊNH KỲ
定期券	ていきけん-vé thường kỳ; vé tháng-ĐỊNH KỲ KHÓAN
対照	たいしょう-(so sánh) đối chiếu, Tương phản, trái ngược-ĐỐI CHIẾU
対照的	たいしょうてき-tính đối chiếu-ĐỐI CHIẾU ĐÍCH
履歴書	りれきしょ-sơ yếu lý lịch -LÝ LỊCH THƯ
巻き戻し	まきもどし-Tua lại-QUYỂN LỆ
布団	ふとん-chăn, mền -BỐ ĐÒAN
往復	おうふく-khứ hồi, cả đi cả về -VÃNG PHỤC
復習	ふくしゅう-ôn tập -PHỤC TẬP
戻る	もどる-quay lại, trở lại -LỆ
手伝う	てつだう-giúp đỡ -THỦ TRUYỀN, TRUYỆN
払い戻し	はらいもどし-hoàn trả ( tiền )-PHẤT LỆ
払う	はらう-trả, trả tiền -PHẤT
拡大	かくだい-Mở rộng, bành trướng-KHUẾCH ĐẠI
拾う	ひろう-lượm-THẬP
指	ゆび-ngón tay -CHỈ(SÁP, THÁP)
指す	さす-giương (ô ), giơ (tay)-CHỈ(SÁP, THÁP)
指定席	していせき-ghế chỉ định, ghế đã đặt trước -CHỈ(SÁP, THÁP) ĐỊNH TỊCH
指示	しじ-chỉ thị -CHỈ(SÁP, THÁP) THỊ
掃除	そうじ-dọn dẹp, quét dọn -TẢO TRỪ
掲示	けいじ-Thông báo-YẾT THỊ
携帯電話	けいたいでんわ-điện thoại di động -HUỀ ĐỚI, ĐÁI ĐiỆN THOẠI
支える	ささえる-nâng đỡ, đỡ -CHI
支店	してん-cửa hàng chi nhánh -CHI ĐiẾM
支払う	しはらう-chi trả -CHI PHẤT
数を数える	かずをかぞえる-đếm số lượng -SỐ SỐ
数字	すうじ-chữ số, con số-SỐ TỰ
数学	すうがく-toán học, số học -SỐ HỌC
数量	すうりょう-Số lượng, khối lượng-SỐ LƯỢNG
整う	ととのう-Được chuẩn bị-CHỈNH
新緑	しんりょく-Màu xanh của cây cỏ-TÂN LỤC
新規	しんき-Mới lạ, mới mẻ-TÂN QUI
旅券	りょけん-Hộ chiếu-LỮ KHÓAN
日本式	にほんしき-kiểu nhật -NHẬT BẢN THỨC
明確（な）	めいかく（な）-sự rõ ràng và chính xác -MINH XÁC
映像	えいぞう-hình ảnh -ÁNH TƯỢNG
時刻表	じこくひょう-thời khóa biểu -THỜI, THÌ KHẮC BIỂU
普段（の）	ふだん（の）-bình thường, thường thường -PHỔ ĐỌAN
普通	ふつう-phổ thông, thông thường -PHỔ THÔNG
暖かい	あたたかい-nóng, ấm áp -NÕAN
暖房	だんぼう-lò sưởi -NÕAN PHÒNG
書き取り	かきとり-viết chính tả -THƯ THỦ
書式	しょしき-Định dạng-THƯ THỨC
書類	しょるい-tài liệu, giấy tờ -THƯ LOẠI
期間	きかん-kì, thời kì -KỲ GIAN, GIÁN
未定	みてい-Chưa quyết định, chưa chắc chắn-VỊ, MÙI ĐỊNH
未来	みらい-tương lai gần -VỊ, MÙI LAI
枚数	まいすう-số tờ, số tấm -MAI SỐ
機能	きのう-chức năng, tính năng -CƠ NĂNG
欧米	おうべい-Âu mỹ-ÂU MỄ
正式	せいしき-Trang trọng, chính thức-CHÍNH THỨC
歴史	れきし-lịch sử -LỊCH SỬ
残す	のこす-chừa lại, để lại -TÀN
残る	のこる-còn lại, sót lại -TÀN
残高照会	ざんだかしょうかい-vấn tin số dư -TÀN CAO CHIẾU HỘI
水準	すいじゅん-Tiêu chuẩn, mức độ, trình độ-THỦY CHUẨN
水玉	みずたま-chấm tròn (trên vải )-THỦY NGỌC
決まる	きまる-quyết định -QUYẾT
決める	きめる-quyết, quyết định -QUYẾT
決定	けってい-quyết định -QUYẾT ĐỊNH
沈む	"しずむ -1. chìm; đắm 2. buồn bã; đau khổ-TRẦM"
浮く	うく-nổi; lơ lửng-PHÙ
消しゴム	けしゴム-tẩy, cục tẩy -TIÊU
消す	けす-tắt, xóa-TIÊU
消去	しょうきょ-Loại bỏ-TIÊU KHỬ, KHỨ
済む	すむ-kết thúc, hoàn tất -TẾ
温かい	あたたかい-ấm, ấm áp -ÔN
温室	おんしつ-nhà kính -ÔN THẤT
温帯	おんたい-ôn đới -ÔN ĐỚI, ĐÁI
温度	おんど-nhiệt độ -ÔN ĐỘ
温暖（な）	おんだん（な）-ấm, ấm áp -ÔN NÕAN
湿る	しめる-ẩm ướt-THẤP
湿度	しつど-Độ ẩm-THẤP ĐỘ
点数	てんすう -điểm số -ĐiỂM SỐ
照らす	てらす-Soi sáng, chiếu rọi-CHIẾU
片付ける	かたづける-dọn dẹp -PHIẾN PHÓ
片道切符	かたみちきっぷ-vé một chiều -PHIẾN ĐẠO THIẾT PHÙ
玉	たま-hạt ngọc, đồng tiền xu-NGỌC
現れる	あらわれる-xuất hiện; lộ ra-HIỆN
現像	げんぞう-rửa phim-HIỆN TƯỢNG
現金	げんきん -tiền mặt -HIỆN KIM
画像	がぞう-hình ảnh, hình tượng -HỌA, HOẠCH TƯỢNG
留学	りゅうがく-du học -LƯU HỌC
留守	るす -vằng nhà -LƯU THỦ, THÚ
発表	はっぴょう-phát biểu -PHÁT BIỂU
登録	とうろく-đăng ký -ĐĂNG LỤC
着信履歴	ちゃくしんりれき-lịch sử cuộc gọi -TRƯỚC TÍN LÝ LỊCH
破片	はへん-Mảnh vụn, mảnh vỡ-PHÁ PHIẾN
硬い	かたい-cứng, cứng rắn -NGẠNH
硬貨	こうか-Đồng tiền, tiền đồng-NGẠNH HÓA
確か（な）	たしか（な）-chính xác -XÁC
確かめる	たしかめる-sự xác nhận, làm cho rõ ràng -XÁC
確定	かくてい-Xác định, quyết định-XÁC ĐỊNH
確認	かくにん-xác nhận -XÁC NHẬN
約～	やく～-ước khoảng ~ -ƯỚC
約束	やくそく-lời hứa, quy ước -ƯỚC THÚC
紅茶	こうちゃ-hồng trà, trà đen -HỒNG TRÀ
終了	しゅうりょう-kết thúc việc gì đó, hoàn thành -CHUNG LIỄU
緑（色）	みどり（いろ）-xanh, xanh lá cây -LỤC SẮC
緑茶	りょくちゃ-Chè xanh, chè tươi-LỤC TRÀ
編み物	あみもの-đồ đan len-BIÊN VẬT
縮小	しゅくしょう-Cắt giảm, thu nhỏ, nén lại-SÚC TIỂU
習得	しゅうとく-Thu được, lĩnh hội-TẬP ĐẮC
老いる	おいる-Già, già lão-LÃO
老人	ろうじん-người già -LÃO NHÂN
聞き取り	ききとり-nghe hiểu -VĂN THỦ
能力	のうりょく-năng lực -NĂNG LỰC
自信	じしん-tự tin-TỰ TÍN
自動券売機	じどうけんばいき-máy bán hàng tự động -TỰ ĐỘNG KHÓAN MẠI CƠ
若い	わかい-trẻ; trẻ trung-NHƯỢC
表	おもて／ひょう-bề ngoài, mặt ngoài／biểu, bảng, phiếu-BIỂU
表す	あらわす-biểu thị, biểu hiện -BIỂU
表示	ひょうじ-hiển thị -BIỂU THỊ
見積もる	みつもる-Đánh giá, ước lượng-KIẾN TÍCH
設定	せってい-thiết lập, tạo ra -THIẾT ĐỊNH
設計	せっけい-thiết kế -THIẾT KẾ
認める	みとめる-thừa nhận, công nhận -NHẬN
認め印	みとめいん-con dấu (thay cho chữ ký)-NHẬN ẤN
調べる	しらべる-điều tra, tra -ĐiỀU, ĐiỆU
貨物	かもつ-Hàng hoá, hàng chuyên chở-HÓA VẬT
販売	はんばい-bán, việc bán -PHÁN MẠI
返す	かえす-trả, trả lại -PHẢN
返事	へんじ-hồi âm, trả lời -PHẢN SỰ
返済	へんさい-Trả lại tiền-PHẢN TẾ
返金	へんきん-Hoàn trả tiền-PHẢN KIM
送信箱	そうしんばこ-hộp thư đi -TỐNG TÍN SƯƠNG, TƯƠNG
運転切換	うんてんきりかえ-Chuyển đổi hoạt động-VẬN CHUYỂN THIẾT HÓAN
違い	ちがい-sai -VI(VĨ)
適合	てきごう-Thích hợp, thích nghi-THÍCH HỢP
選ぶ	えらぶ-chọn -THIÊN(TUYỂN)
選手	せんしゅ-tuyển thủ -THIÊN(TUYỂN) THỦ
選択	せんたく -tuyển chọn, chọn lựa -THIÊN(TUYỂN) TRẠCH
選考	せんこう-Lựa chọn-THIÊN(TUYỂN) KHẢO
量る	はかる-cân, đo -LƯỢNG
録画	ろくが-ghi hình, ghi băng video-LỤC HỌA, HOẠCH
録音	ろくおん-ghi âm -LỤC ÂM
間違い	まちがい-nhầm lẫn -GIAN, GIÁN VI(VĨ)
間違える	まちがえる-nhầm lẫn -GIAN, GIÁN VI(VĨ)
除く	のぞく-xoá-TRỪ
集団	しゅうだん-Nhóm, tập thể, đoàn thể-TẬP ĐÒAN
音声	おんせい-Giọng nói, thanh âm-ÂM THANH
音量	おんりょう-Âm lượng-ÂM LƯỢNG
預かる	あずかる-trông nom, chăm sóc -DỰ
預ける	あずける-giao cho, giao phó, gửi -DỰ
預金	よきん-gửi tiền -DỰ KIM
風の向き	かぜのむき-Hướng gió-PHONG HƯỚNG
風量	ふうりょう-Khối lượng không khí-PHONG LƯỢNG
飛行機	ひこうき-máy bay -KHIÊU(PHI) HÀNH, HÀNG, HẠNH CƠ
上等	じょうとう-Tuyệt hảo, chất lượng tốt, thượng hạng-THƯỢNG ĐẲNG
事柄	ことがら-Sự việc, vấn đề-SỰ BÍNH
交渉	こうしょう-Thương thảo, đàm phán-GIAO THIỆP
任せる	まかせる-hết sức, dốc lòng-NHIỆM
作法	さほう-Cách cư xử-TÁC PHÁP
分担	ぶんたん-gánh vác (trách nhiệm)-PHÂN ĐẢM
刑事	けいじ-Hình sự-HÌNH SỰ
務める	つとめる-Làm việc; Giữ nhiệm vụ, làm công tác-VỤ
協会	きょうかい-tổ chức, hiệp hội -HIỆP HỘI
去る	さる-Qua đi, rời đi-KHỬ, KHỨ
在中	ざいちゅう-có chứa (giấy tờ, tài liệu...) bên trong-TẠI TRUNG, TRÚNG
客席	きゃくせき-ghế khán giả, ghế ngồi xem-KHÁCH TỊCH
新装開店	しんそうかいてん-Mở cửa kinh doanh sau khi trang trí lại cửa tiệm-TÂN TRANG KHAI ĐiẾM
服装	ふくそう-Quần áo, trang phục-PHỤC TRANG
果実	かじつ-Quả-QUẢ THỰC
根拠	こんきょ-Cơ bản, nền tảng-CĂN CỨ
気配	けはい-cảm giác, linh cảm, dấu hiệu-KHÍ PHỐI
異変	いへん-Tai nạn, sự khác thường-DỊ BiẾN
移転	いてん-di chuyển; chuyển giao-DI CHUYỂN
落ち葉	おちば-Lá rơi, lá rụng-LẠC DIỆP
衣服	いふく-y phục, trang phục -Y PHỤC
負う	おう-Đảm đương, gánh vác-PHỤ
負担	ふたん-gánh vác -PHỤ ĐẢM
貯蔵	ちょぞう-tàng trữ, dự trữ, chứa-TRỮ TÀNG
込める	こめる-Tống vào, nạp vào-VÀO
領	りょう-Lãnh thổ-LĨNH, LÃNH
領収書	りょうしゅうしょ-biên lai-LĨNH, LÃNH THU THƯ
包装	ほうそう-Đóng gói, gói lại-BAO TRANG
外相	がいしょう-Bộ trưởng ngoại giao-NGOẠI TƯƠNG, TƯỚNG
相当	そうとう-Đáng kể, kha khá-TƯƠNG, TƯỚNG ĐANG, ĐƯƠNG
～し難い	～しがたい-khó ～-NẠN
～と共に	～とともに-cùng với ~ -CỘNG
～位	～い-vị trí-VỊ
～個	～こ-cái ~ (đếm vật hình khối)-CÁ
～各位	～かくい-các vị; các ngài; kính gửi các quý vị; gửi toàn thể-CÁC VỊ
～様	～さま-ngài -DẠNG
～殿	～どの-Bà, ngài-ĐiỆN
～相当	～そうとう-tương đương -TƯƠNG, TƯỚNG ĐANG, ĐƯƠNG
～等	～など-~ vân vân -ĐẲNG
～製	～せい-hàng ~ -CHẾ
～軒	～けん-～căn, nhà (đếm tòa nhà)-hiên
～限り	～かぎり-theo như ~-HẠN
～領	～りょう-quản trị -LĨNH, LÃNH
お参り	おまいり-sự lễ chùa -TAM, THAM
お客様	おきゃくさま-quý khách-KHÁCH DẠNG
お越しの際（＝来たとき）	おこしのさい（＝きたとき）-khi đến -VIỆT TẾ LAI
ゴミ集積所	ゴミしゅうせきじょ-Điểm thu gom rác-TẬP TÍCH SỞ
その他	そのた-cái khác, ngoài ra-THA
レジ袋	レジぶくろ -túi nhựa (nhận tại quầy tính tiền)-ĐẠI
下記	かき-Như sau, như bên dưới-HẠ KÝ
不在	ふざい-Vắng mặt-BẤT TẠI
不燃	ふねん-Không cháy, không bắt lửa-BẤT NHIÊN
中毒	"ちゅうどく-1. trúng độc 2. ghiền, nghiện-TRUNG, TRÚNG ĐỘC"
主役	しゅやく-Chỉ huy, đứng đầu-CHỦ DỊCH
乗り越す	のりこす-vượt qua -THỪA, THẶNG VIỆT
乗客	じょうきゃく-hành khách -THỪA, THẶNG KHÁCH
事務	じむ-công việc -SỰ VỤ
事務所	じむしょ-nơi làm việc, văn phòng -SỰ VỤ SỞ
交換	こうかん-trao đổi -GIAO HÓAN
交流	こうりゅう-giao lưu -GIAO LƯU
交通機関	こうつうきかん-cơ quan giao thông -GIAO THÔNG CƠ QUAN
交際	こうさい-mối quan hệ, giao du-GIAO TẾ
他人	たにん-người khác -THA NHÂN
他方	たほう-hướng khác, phương khác -THA PHƯƠNG
任務	にんむ-Nhiệm vụ, công việc-NHIỆM VỤ
伝染病	でんせんびょう-Bệnh truyền nhiễm-TRUYỀN, TRUYỆN NHIỄM BỆNH
位	い-Hạng, thứ, vị trí-VỊ
住居	じゅうきょ-Nơi cư trú-TRÚ CƯ
便利（な）	べんり（な）-tiện lợi, thuận tiện -TIỆN LỢI
保管	ほかん-Bảo quản, canh giữ, trông coi-BẢO QUẢN
個々	ここ-từng cái, từng -CÁ
個人	こじん-cá nhân -CÁ NHÂN
個別	こべつ-cá biệt -CÁ BIỆT
入荷	にゅうか-nhận hàng, nhập hàng -NHẬP HÀ
全～	ぜん～-toàn ~ -TÒAN
全く	まったく-tất cả -TÒAN
全て	すべて-tất cả -TÒAN
全国	ぜんこく-toàn quốc -TÒAN QUỐC
共通	きょうつう-cộng đồng -CỘNG THÔNG
内容	ないよう-nội dung -NỘI DUNG
内臓	ないぞう-Nội tạng-NỘI TẠNG
円周	えんしゅう-Chu vi-VIÊN CHU
冷凍	れいとう-làm lạnh, làm đông lạnh -LÃNH ĐỐNG
冷蔵	れいぞう-làm lạnh -LÃNH TÀNG
凍える	こごえる-bị đóng băng -ĐỐNG
凍る	こおる-đóng băng -ĐỐNG
出荷	しゅっか-đưa hàng, giao hàng -XUẤT HÀ
利用	りよう-sử dụng -LỢI DỤNG
加える	くわえる-gia tăng, thêm vào -GIA
加わる	くわわる-tham gia, gia nhập -GIA
加速	かそく-gia tốc, làm nhanh thêm -GIA TỐC
効き目	ききめ-Công dụng, tác dụng-HIỆU MỤC
効く	きく-có hiệu quả, có kết quả-HIỆU
効果	こうか-hiệu quả -HIỆU QUẢ
協力	きょうりょく-hợp tác, hiệp lực -HIỆP LỰC
協定	きょうてい-Hiệp định, hiệp ước-HIỆP ĐỊNH
参る	まいる-đi -TAM, THAM
参加	さんか-tham gia -TAM, THAM GIA
参考書	さんこうしょ-sách tham khảo -TAM, THAM KHẢO THƯ
収める	おさめる-thu được, giao nộp-THU
収入	しゅうにゅう-thu nhập -THU NHẬP
収集	しゅうしゅう-Thu thập, thu gom-THU TẬP
受話器	じゅわき-Ống nghe điện thoại-THỤ THOẠI KHÍ
可燃	かねん-Cháy-KHẢ NHIÊN
各～	かく～-mỗi, các ~ -CÁC
各位	かくい-Kính gởi các quí vị, gởi toàn thể-CÁC VỊ
各地	かくち-các đại phương, các nơi -CÁC ĐỊA
各自	かくじ-mỗi cá nhân -CÁC TỰ
同封	どうふう-gửi kèm theo-ĐỒNG PHONG
同案異義語	どうあんいぎご-đồng từ khác nghĩa -ĐỒNG ÁN DỊ NGHĨA NGỮ
同様	どうよう-đồng dạng, như -ĐỒNG DẠNG
同音異義語	どうおんいぎご-Chữ đồng âm dị nghĩa-ĐỒNG ÂM DỊ NGHĨA NGỮ
吸収	きゅうしゅう-Tiếp thu, tiếp quản-HẤP THU
周り	まわり-xung quanh-CHU
商品	しょうひん-hàng hóa, sản phẩm -THƯƠNG PHẨM
商売	しょうばい-Kinh doanh-THƯƠNG MẠI
商店	しょうてん-cửa hiệu, cửa hàng buôn bán -THƯƠNG ĐiẾM
商業	しょうぎょう-buôn bán, thương mại -THƯƠNG NGHIỆP
器	うつわ-Đồ dùng, dụng cụ-KHÍ
器械体操	きかいたいそう-máy tập thể dục -KHÍ GIỚI THỂ THÁO, THAO
回収	かいしゅう-thu hồi, thu lại -HỒI THU
困難（な）	こんなん（な）-khó khăn, vất vả -KHỐN NẠN
在学	ざいがく-Theo học, đang học-TẠI HỌC
地位	ちい-vị trí, địa vị -ĐỊA VỊ
地震	じしん-động đất -ĐỊA CHẤN
埋まる	うまる-bị lấp đầy -MAI
埋める	うめる-chon, chôn cất -MAI
埋め立てる	うめたてる-lấp đất-MAI LẬP
変更	へんこう-biến đổi -BiẾN CANH
大統領	だいとうりょう-tổng thống -ĐẠI THỐNG LĨNH, LÃNH
完全（な）	かんぜん（な）-toàn bộ, hoàn toàn -HÒAN TÒAN
容器	ようき-Đồ đựng-DUNG KHÍ
封書	ふうしょ-Thư đã cho vào dán kín-PHONG THƯ
小枝	こえだ-cành cây nhỏ -TIỂU CHI
届く	とどく-đến, tới -GIỚI
届ける	とどける-đưa đến, đưa tới -GIỚI
届け出	とどけで-thông báo, báo cáo-GIỚI XUẤT
平ら	たいら-Bằng phẳng, phẳng-BÌNH
平仮名	ひらがな-chữ hiragana-BÌNH GIẢ DANH
平成	へいせい-thời đại Bình Thành-BÌNH THÀNH
平日	へいじつ-ngày thường -BÌNH NHẬT
平気（な）	へいき（な）-bình tĩnh -BÌNH KHÍ
平等	びょうどう-Bình đẳng, không thiên vị-BÌNH ĐẲNG
延ばす	のばす-làm giãn ra-DIÊN
延びる	のびる-kéo dài, giãn ra -DIÊN
延期	えんき-Hoãn lại-DIÊN KỲ
延長	えんちょう-kéo dài -DIÊN TRƯỜNG, TRƯỞNG
弁当	べんとう-cơm hộp -BIỆN ĐANG, ĐƯƠNG
引っ越す	ひっこす-dọn nhà -DẪN VIỆT
当～	とう～-～ này -ĐANG, ĐƯƠNG
当たる	あたる-đúng (trả lời), trúng (đạn)-ĐANG, ĐƯƠNG
当日	とうじつ-ngày hôm đó -ĐANG, ĐƯƠNG NHẬT
心細い	こころぼそい-Đơn độc, cô đơn, buồn bã-TĂM TẾ
心配（な）	しんぱい（な）-lo lắng -TĂM PHỐI
必ず	かならず-nhất định -TẤT
必死	ひっし-quyết tâm -TẤT TỬ
必要（な）	ひつよう（な）-cần thiết, tất yếu -TẤT YÊU, YẾU
忘れる	わすれる-quên, bỏ quên -VONG
忘れ物	わすれもの-đồ bỏ quên, vật bỏ quên -VONG VẬT
忘年会	ぼうねんかい-tiệc cuối năm -VONG NIÊN HỘI
思い込む	おもいこむ-Tin, nghĩ rằng-TƯ VÀO
手袋	てぶくろ -bao tay, găng tay -THỦ ĐẠI
払い込む	はらいこむ-Giao nộp, giao tiền-PHẤT VÀO
折り曲げる	おりまげる-Gấp-CHIẾT, TRIẾT KHÚC
担任	たんにん-Giáo viên chủ nhiệm-ĐẢM NHIỆM
担当	たんとう-đảm đương, trách nhiệm -ĐẢM ĐANG, ĐƯƠNG
持参	じさん-Đem theo, mang theo-TRÌ TAM, THAM
教訓	きょうくん-Bài học-GIÁO HUẤN
文法	ぶんぽう-ngữ pháp -VĂN PHÁP
断る	ことわる-từ chối, bác bỏ -ĐÓAN
断定	だんてい-kết luận -ĐÓAN ĐỊNH
断水	だんすい-cắt nước -ĐÓAN THỦY
方法	ほうほう-phương pháp -PHƯƠNG PHÁP
日記	にっき-nhật ký -NHẬT KÝ
日誌	にっし-Sổ nhật ký, sổ ghi nhớ-NHẬT CHÍ
明細	めいさい-Chi tiết, rõ ràng-MINH TẾ
昨～	さく～-～ trước-TẠC
曲	きょく-khúc (nhạc )-KHÚC
曲がる	まがる-rẽ, uống cong-KHÚC
曲線	きょくせん-Đường cong, đường vòng-KHÚC TUYẾN
更新	こうしん-Cập nhật, đổi mới-CANH TÂN
更衣室	こういしつ-Phòng thay quần áo-CANH Y THẤT
有利（な）	ゆうり（な）-có ích, có lợi -HỮU LỢI
有効	ゆうこう-có hiệu quả, hữu hiệu-HỮU HIỆU
期限	きげん-thời hạn, kỳ hạn -KỲ HẠN
果たす	はたす-Hoàn thành-QUẢ
果物	くだもの-trái cây-QUẢ VẬT
枝	えだ-cành cây -CHI
植物	しょくぶつ-Thực vật, cây cối-THỰC VẬT
楽器	がっき-Nhạc cụ-NHẠC, LẠC KHÍ
様々（な）	さまざま（な）-đa dạng, nhiều loại -DẠNG
様子	ようす-tình trạng -DẠNG TỬ, TÝ
横断	おうだん-băng qua-HOẠNH, HOÀNH ĐÓAN
機械	きかい-cơ khí, máy móc -CƠ GIỚI
殿様	とのさま-vua chúa -ĐiỆN DẠNG
気の毒	きのどく-Đáng thương, đáng thương hại-KHÍ ĐỘC
水道管	すいどうかん-Ống nước-THỦY ĐẠO QUẢN
汚い	きたない-dơ, bẩn thỉu -Ô
汚す	よごす-làm bẩn -Ô
汚れる	よごれる-bị bẩn, dơ -Ô
汚染	おせん-ô nhiễm -Ô NHIỄM
法人	ほうじん-Pháp nhân-PHÁP NHÂN
消毒	しょうどく-tiêu độc; khử trùng-TIÊU ĐỘC
涙	なみだ-nước mắt-LỤY, LỆ
燃やせる	もやせる-Cháy-NHIÊN
燃料	ねんりょう-Nhiên liệu, chất đốt-NHIÊN LIỆU
現在	げんざい-hiện tại -HIỆN TẠI
現象	げんしょう-Hiện tượng-HIỆN TƯỢNG
申し込む	"もうしこむ-1. đàm phán, thương lượng 2. đặt hàng 3. cầu hôn-THÂN VÀO"
畑	はたけ-ruộng, ruộng nương -VƯỜN
異なる	ことなる-khác, khác với -DỊ
異常（な）	いじょう（な）-không bình thường-DỊ THƯỜNG
相変わらず	あいかわらず-Vẫn, như mọi khi-TƯƠNG, TƯỚNG BiẾN
相手	あいて-đối phương, đối thủ -TƯƠNG, TƯỚNG THỦ
相撲	すもう-sumo-TƯƠNG, TƯỚNG BỘC, PHỐC
移す	うつす-dọn đi, chuyển đi -DI
移る	うつる-di chuyển -DI
移動	いどう-di chuyển -DI ĐỘNG
積む	つむ-chất, xếp -TÍCH
積もる	つもる-được chất đống -TÍCH
笑う	わらう-cười-TiẾU
笑む	えむ-mỉm cười-TiẾU
等	など-vân vân-ĐẲNG
等しい	ひとしい-Bằng, ngang nhau-ĐẲNG
管	かん-Ống, ống dẫn-QUẢN
管理	かんり-quản lý -QUẢN LÝ
紅葉	こうよう-lá đỏ -HỒNG DIỆP
細い	ほそい-gầy, ốm -TẾ
細かい	こまかい-chi tiết, tỉ mỉ -TẾ
経済	けいざい-kinh tế -KINH TẾ
経理	けいり-kế toán -KINH LÝ
経過	けいか-tiến trình, sự trải qua-KINH OA(QUÁ)
経験	けいけん-kinh nghiệm -KINH NGHIỆM
結ぶ	むすぶ-buộc, nối -KẾT
結局	けっきょく-kết cục -KẾT CỤC
結果	けっか-kết quả -KẾT QUẢ
練習	れんしゅう-luyện tập -LUYỆN TẬP
美容	びよう-vẻ đẹp, dung nhan-MỸ DUNG
翌～	よく～-～ sau-DỰC
翌日	よくじつ-Ngày hôm sau-DỰC NHẬT
翌朝	よくあさ-sáng hôm sau-DỰC TRIỀU
花畑	はなばたけ -Vườn hoa-HOA VƯỜN
荷物	にもつ-hành lý -HÀ VẬT
葉	は-lá -DIỆP
衣料品	いりょうひん-Hàng may mặc-Y LIỆU PHẨM
衣装	いしょう-Quần áo, y phục-Y TRANG
衣類	いるい-quần áo -Y LOẠI
衣食住	いしょくじゅう-Miếng cơm manh áo và chỗ nương thân-Y THỰC TRÚ
袋	ふくろ-bao, túi -ĐẠI
製品	せいひん-hàng hóa, sản phẩm -CHẾ PHẨM
要る	いる-cần-YÊU, YẾU
要点	ようてん-Ý chính-YÊU, YẾU ĐiỂM
要約	ようやく-Tóm tắt, tóm lược-YÊU, YẾU ƯỚC
言葉	ことば-từ vựng -NGÔN DIỆP
訓練	くんれん-Tập huấn, huấn luyện-HUẤN LUYỆN
訓読み	くんよみ-cách đọc âm hán trong tiếng nhật -HUẤN ĐỘC
記す	しるす-Ghi chép lại-KÝ
記事	きじ-Tin tức, bài báo-KÝ SỰ
記入	きにゅう-ghi vào, điền vào -KÝ NHẬP
記号	きごう-ký hiệu -KÝ HIỆU
記者	きしゃ-Kí giả, phóng viên-KÝ GIẢ
負ける	まける-thua -PHỤ
責める	せめる-Buộc tội, kết tội-TRÁCH
責任	せきにん-trách nhiệm -TRÁCH NHIỆM
資料	しりょう -tài liệu -TƯ LIỆU
資源	しげん-tài nguyên -TƯ NGUYÊN
資金	しきん-Quỹ, tiền, vốn-TƯ KIM
足袋	たび-tất có ngón của nhật -TÚC ĐẠI
込む	こむ-đông đúc -VÀO
近郊	きんこう-Ngoại ô (phạm vi rộng hơn 郊外）-CÂ?N GIAO
迷う	まよう-lạc đường -MÊ
迷信	めいしん-Mê tín, dị đoan-MÊ TÍN
迷子	まいご-trẻ lạc -MÊ TỬ, TÝ
迷惑	めいわく-phiền hà, quấy rầy -MÊ HOẶC
通過	つうか-đi qua, vượt qua-THÔNG OA(QUÁ)
連れる	つれる-dẫn theo, dắt -LIÊN
連休	れんきゅう-kỳ nghỉ, đợt nghỉ -LIÊN HƯU
連絡	れんらく-liên lạc-LIÊN LẠC
連続	れんぞく-Tiếp tục, liên tục-LIÊN TỤC
過ぎる	すぎる-quá, vượt quá -OA(QUÁ)
過ごす	すごす-trải qua -OA(QUÁ)
過去	かこ-quá khứ -OA(QUÁ) KHỬ, KHỨ
避難	ひなん-lánh nạn, tị nạn -TỴ NẠN
郊外	こうがい-Ngoại ô-GIAO NGOẠI
配る	くばる-phân phát, phân phối -PHỐI
配達	はいたつ-phân phát, đưa cho -PHỐI ĐẠT
重要（な）	じゅうよう（な）-quan trọng, trọng yếu -TRỌNG, TRÙNG YÊU, YẾU
金利	きんり-Lãi suất, tiền lãi-KIM LỢI
金額	きんがく-kim ngạch -KIM NGẠCH
開封	かいふう-Mở thư-KHAI PHONG
関連	かんれん-Mối quan hệ, liên quan-QUAN LIÊN
限度額	げんどがく-Hạn mức tín dụng-HẠN ĐỘ NGẠCH
限界	げんかい-giới hạn -HẠN GIỚI
雑な	ざつな-Linh tinh; tạp nham-TẠP
雑用	ざつよう-Việc lặt vặt-TẠP DỤNG
雑誌	ざっし-tạp chí -TẠP CHÍ
雑貨	ざっか-Đồ lặt vặt-TẠP HÓA
雑音	ざつおん-tạp âm -TẠP ÂM
難しい	むずかしい-khó (bài tập )-NẠN
震える	ふるえる-Rung, lay động-CHẤN
面積	めんせき-diện tích -DIỆN TÍCH
頂く	いただく-xin nhận -ĐỈNH
頂上	ちょうじょう-đỉnh núi, đỉnh -ĐỈNH THƯỢNG
頂点	ちょうてん-Đỉnh cao, đỉnh điểm-ĐỈNH ĐiỂM
領事館	りょうじかん-lãnh sự quán-LĨNH, LÃNH SỰ QUÁN
額	ひたい-trán -NGẠCH
額	がく-kim ngạch; khoản tiền; số tiền; mức tiền-NGẠCH
願う	ねがう-cầu mong, cầu xin-NGUYỆN
願書	がんしょ-đơn xin nhập học -NGUYỆN THƯ
飛び込む	とびこむ-nhảy vào, lao vào -KHIÊU(PHI) VÀO
食器	しょっき-dụng cụ ăn ( chén, bát )-THỰC KHÍ
首相	しゅしょう-thủ tướng -THỦ TƯƠNG, TƯỚNG
高等学校	こうとうがっこう-trường cao đẳng-CAO ĐẲNG HỌC HIỆU