一緒に	いっしょに 	cùng lúc, cùng nhau	[NHẤT TỰ]
行儀	ぎょうぎ 	cách cư xử	[HÀNH, HÀNG, HẠNH NGHI]
メモを取る	メモをとる 	ghi chép, ghi nhớ	[THỦ]
一方	いっぽう 	một mặt/mặt khác	[NHẤT PHƯƠNG]
話し合い	はなしあい 	thảo luận	[THOẠI HỢP]
戦い
たたかい		chiến đấu	[CHIẾN]
続ける	つづける 	tiếp tục	[TỤC]
整備	せいび 	điều chỉnh, chỉnh sửa	[CHỈNH BỊ]
近代化
きんだいか		hiện đại hóa	[CÂ?N ĐẠI HÓA]
政府	せいふ 	chính phủ	[CHÍNH PHỦ]
政策	せいさく 	chính sách	[CHÍNH SÁCH]
撤退する
てったいする		rút lui, rút khỏi	[TRIỆT THÓAI]
減らす	へらす 	cắt bớt, thu nhỏ, làm giảm	[GIẢM]
シャッターを切る		bấm nút 	chụp hình	[THIẾT]
話しかける	はなしかける 	bắt chuyện	[THOẠI]
元々	もともと 	vốn dĩ, nguyên là	[NGUYÊN]
黙る	だまる 	giữ yên lặng	[MẶC]
原稿
げんこう		bản thảo, bản nháp	[NGUYÊN CẢO]
穴	あな 	hầm, hố, hang, hốc	[HUYỆT]
掘る
ほる		đào, xới	[QUẬT]
土砂崩れ
どしゃくずれ		sự lở đất	[THỔ SA BĂNG]
崩れる
くずれる		đổ, sập, sụp	[BĂNG]
或いは
あるいは		hoặc, hoặc là
感じ	かんじ 	cảm giác	[CẢM]
以外	いがい 	ngoại trừ, ngoại lệ	[DĨ NGOẠI]
意思	いし 	ý chí	[Ý TƯ]
携帯	けいたい 	di động	[HUỀ ĐỚI, ĐÁI]
鳴る	なる 	reng, rung 	chuông đt	[MINH]
金庫
きんこ		két sắt, két bạc	[KIM KHỐ]
非常ベル
ひじょうベル		chuông báo động	[PHI THƯỜNG]
腹	はら 	bụng	[PHÚC]
腹が立つ
はらがたつ		phát tức	[PHÚC LẬP]
代金	だいきん 	tiền hàng, thanh toán	[ĐẠI KIM]
互い
たがい 		lẫn nhau, qua lại	[HỖ]
助け合う
たすけあう 		hợp tác giúp đỡ lẫn nhau	[TRỢ HỢP]
下ろす	おろす 	rút 	tiền, hạ xuống, cho xuống, hạ 	buồm	[HẠ]
思い浮かべる
おもいうかべる		nhớ lại, hồi tưởng lại	[TƯ PHÙ]
卒業	そつぎょう 	tốt nghiệp	[TỐT, THỐT NGHIỆP]
弁当	べんとう 	cơm hộp	[BIỆN ĐANG, ĐƯƠNG]
準備	じゅんび 	chuẩn bị	[CHUẨN BỊ]
置き換える
おきかえる		thay thế	[TRỊ HOÁN]
例文	れいぶん 	mẫu câu	[LỆ VĂN]
接続	せつぞく 	kết nối	[TIẾP TỤC]
注目	ちゅうもく 	chú ý, để ý đến	[CHÚ MỤC]
映画	えいが 	phim	[HỌA DIỆN]
涙	なみだ 	nước mắt	[LỆ]
暫く
しばらく 		một chút, một lát	[TẠM]
海外旅行	かいがいりょこう 	du lịch nước ngoài	[HẢI NGOẠI LỮ HÀNH]
就職	しゅうしょく 	hoạt động tìm việc, nhậm chức	[TỰU CHỨC]
夕方	ゆうがた 	hoàng hôn, chiều tối	[TỊCH PHƯƠNG]
際	さい 	khi	[TẾ]
抜く	ぬく 	rút, nhổ, lược, bỏ	[BẠT]
デジカメ		máy ảnh kỹ thuật số
調整する	ちょうせいする 	sự điều chỉnh	[ĐIỀU CHỈNH]
仕上がる
しあがる		hoàn thành, rửa 	phim	[SĨ THƯỢNG]
希望	きぼう 	kì vọng, hi vọng	[HI VỌNG]
取引先	とりひきさき 	khách hàng	[THỦ DẪN TIÊN]
挨拶	あいさつ 	chào hỏi
焼き鳥屋	やきとりや 	tiệm gà nướng	[THIÊU ĐIỂU Ốc]
電卓	でんたく 	máy tính	[ĐIỆN TRÁC]
訪ねる
たずねる 		ghé thăm, hỏi thăm, viếng thăm	[PHỎNG, PHÓNG]
場面	ばめん 	bối cảnh, thời điểm	[TRƯỜNG DIỆN]
新婚	しんこん 	tân hôn	[TÂN HÔN]
ほやほや		tươi, mới
改札口	かいさつぐち 	cửa soát vé	[CẢI TRÁT KHẨU]
邪魔する	じゃます 	quấy rầy	[TÀ MA]
慣用的な表現
かんようてきなひょうげん		những mẫu câu thường dùng	[QUÁN DỤNG ĐÍCH BIỂU HIỆN]
不動産屋	ふどうさんや 	nhà bất động sản	[BẤT ĐỘNG SẢN Ốc]
高校時代	こうこうじだい 	thời cấp 3	[CAO HIỆU THỜI ĐẠI]
利用する	りようする 	sử dụng, vận dụng	[LỢI DỤNG]
南口	みなみぐち 	cửa phía nam	[NAM KHẨU]
クリーニング		giặt, ủi
薄い	うすい 	mỏng	[BẠC]
申し込み	もうしこみ 	đăng kí	[THÂU NHẬP]
漫画	まんが 	truyện tranh	[MẠN HỌA]
レジ		máy tính tiền
他の	ほかの 	khác	[THA]
降ろす	おろす 	xuống 	xe	[GIÁNG]
卸す
おろす		buôn bán sỉ	[TÁ]
卒業する	そつぎょうする 	tốt nghiệp	[TỐT NGHIỆP]
都合	つごう 	tình huống, điều kiện	[ĐÔNG HỢP]
機会	きかい 	cơ hội	[CƠ HỘI]
返す	かえす 	trả lại	[PHẢN]
コンビニ		cửa hàng tiện lợi 	コンビニエンスストア
寄る	よる 	ghé qua	[KÝ]
報告書	ほうこくしょ 	bản báo cáo	[BÁO CÁO THƯ]
友人	ゆうじん 	người bạn	[HỮU NHÂN]
欠伸	あくび 	ngáp	[KHUYẾT THÂN]
睨む

にらむ		liếc, lườm
もともと		vốn dĩ, nguyên là
戦う	たたかう 	chiến tranh	[CHIẾN]
土砂	どしゃ 	đất và cát	[THỔ SA]
赤ん坊
あかんぼう 		Em bé sơ sinh	[XÍCH PHƯỜNG]
ニコニコ		Cười tủm tỉm ,Mỉm cười .
夢中	むちゅう 	say sưa ,đam mê.	[MỘNG TRUNG, TRÚNG]
ウエイトレス		Chị hầu bàn 
瞬間	しゅんかん 	Chốc lát ,giây lát .	[THUẤN GIAN, GIÁN]
粉々
こなごな		Từng mảnh nhỏ	[PHẤN]
床	ゆか 	sàn nhà	[SÀNG]
落ちる	おちる 	rớt, rơi, rụng	[LẠC]
留守	るす 	Sự vắng nhà .	[LƯU THỦ, THÚ]
詳細
しょうさい		Một cách chi tiết ,tường tận .	[TƯỜNG TẾ]
注文	ちゅうもん 	Đơn hàng ,sự đặt hàng .	[CHÚ VĂN]
当たり	あたり 	Chính xác ,Đúng ,Trúng .	[ĐANG, ĐƯƠNG]
打つ	うつ 	đánh; vỗ; đập; va	[ĐẢ]
支払	しはらい 	Sự chi trả .	[CHI PHẤT]
リード		Sự bứt phá 
シュート		Cú sút bóng .
同点	どうてん 	đồng điểm	[ĐỒNG ĐiỂM]
ホームラン		homerun	môn bóng chày
戦争	せんそう 	chiến tranh	[CHIẾN TRANH]
タイプ		loại, kiểu 	type
次第	しだい 	tùy theo; tùy thuộc; ngay khi	[THỨ ĐỆ]
終了する
しゅうりょうする		chấm dứt; kết thúc	[CHUNG LIỄU]
過去	かこ 	quá khứ; qua; trước	[OA	QUÁ KHỬ, KHỨ]
気付く
きづく 		chú ý đến; để ý; để ý đến; lưu ý;nhận thấy	[KHÍ PHÓ]
確認	かくにん 	sự xác nhận; sự khẳng định;sự phê chuẩn, sự chứng minh	[XÁC NHẬN]
覚める
さめる		tỉnh dậy; tỉnh giấc	[GIÁC]
激闘
げきとう		chiến đấu khốc liệt	[KÍCH, KHÍCH ĐẤU]
一点差	いってんさ 	hơn 1 điểm	[NHẤT ĐiỂM SAI]
勝利する	しょうりする 	chiến thắng, thắng cuộc	[THẮNG LỢI]
真剣	しんけん 	nghiêm chỉnh, đúng đắn	[CHÂN KiẾM]
決断	けつだん 	quyết đoán, quyết định	[QUYẾT ĐÓAN]
首になる
くび になる		đuổi việc, sa thải	[THỦ]
賞を取る	しょうをとる 	nhận phần thưởng	[THƯỞNG THỦ]
念願	ねんがん 	tâm niệm, nguyện vọng, mong mỏi	[NiỆM NGUYỆN]
感激	かんげき 	cảm kích, cảm động	[CẢM KÍCH, KHÍCH]
金銭	きんせん 	tiền bạc	[KIM TIỀN]
依頼する	いらいする 	nhờ vả	[Y LẠI]
金銭問題	きんせんもんだい 	vấn đề tiền bạc, vấn đề tài chính	[KIM TIỀN VẤN ĐỀ]
散々	さんざん 	gay go; khốc liệt; dữ dội; buồn thảm	[TẢN, TÁN]
説教	せっきょう 	thuyết giáo, thuyết đạo lý	[THUYẾT GIÁO]
貸す	かす 	cho vay; cho mượn	[THẢI]
頼む	たのむ 	yêu cầu,đề nghị, nhờ cậy	[LẠI]
学部	がくぶ 	ngành học	[HỌC BỘ]
悩む	なやむ 	lo lắng; buồn phiền	[NÃO]
今回	こんかい 	lần này	[KIM HỒI]
立候補	りっこうほ 	ra ứng cử	[LẬP HẬU BỔ]
発表会	はっぴょうかい 	buổi biểu diễn, buổi ra mắt	[PHÁT BIỂU HỘI]
傷める
いためる		làm đau, gây thương tích	[THƯƠNG]
緊張	きんちょう 	căng thẳng	[KHẨN, CẨN TRƯƠNG]
倒れる	たおれる 	đổ, ngã, lăn ra bất tỉnh	[ĐẢO]
悔しい	くやしい 	tức	[HỐI]
単に	たんに 	đơn thuần, đơn giản	[ĐƠN, ĐAN]
採用する
さいようする		tuyển dụng, thuê	[THẢI DỤNG]
商品	しょうひん 	hàng hóa, sản phầm	[THƯƠNG PHẨM]
通信販売	つうしんはんばい 	buôn ban điện tử	[THÔNG TÍN PHÁN MẠI]
相談する	そうだんする 	thảo luận	[TƯƠNG, TƯỚNG ĐÀM]
件	けん 	vụ, trường hợp, vấn đề, việc	[KIỆN]
決定	けってい 	quyết định	[QUYẾT ĐỊNH]
変更する	へんこうする 	thay đổi, biến đổi	[BiẾN CANH]
結論	けつろん 	kết luận, quyết định	[KẾT LuẬN]
期待外れ	きたいはずれ 	thất vọng	[KỲ ĐÃI NGOẠI]
靴	くつ 	giày	[NGOA]
回る	まわる 	 đi quanh, quay	[HỒI]
電話口	でんわぐち 	ống nói của điện thoại	[ĐiỆN THOẠI KHẨU]
責任者	せきにんしゃ 	người phụ trách	[TRÁCH NHIỆM GIẢ]
効率	こうりつ 	hiệu suất; năng suất; năng lực	[HIỆU SUẤT]
改革	かいかく 	cải cách	[CẢI CÁCH]
残る	のこる 	còn lại; sót lại; còn	[TÀN]
履歴書	りれきしょ 	bản lý lịch, CV	[LÝ LỊCH THƯ]
受け取る	うけとる 	 nhận; tiếp nhận	[THỤ THỦ]
返事	へんじ 	sự trả lời; sự đáp lời	[PHẢN SỰ]
大勢の人	おおぜいのひと 	nhiều người	[ĐẠI THẾ NHÂN]
子猫	こねこ 	mèo con	[TỬ, TÝ MIÊU]
飛び上がる	とびあがる 	nhảy lên	[KHIÊU	PHI THƯỢNG]
両親	りょうしん 	cha mẹ	[LƯỠNG THÂN]
議論	ぎろん 	thảo luận, tranh luận	[NGHỊ LuẬN]
重ねる	かさねる 	chồng lên, chất lên	[TRỌNG, TRÙNG]
恐ろしい	おそろしい 	sợ, kinh khủng	[KHỦNG]
大声	おおごえ 	giọng to, tiếng to	[ĐẠI THANH]
成果	せいか 	thành quả	[THÀNH QUẢ]
観戦	かんせん 	xem đá banh ,bóng chày...	[QUAN CHIẾN]
興奮	こうふん 	hưng phấn	[HỨNG, HƯNG PHẤN]
放り投げる	ほうりなげる 	buông thả, vất bỏ, quăng bỏ	[PHÓNG ĐẦU]
発表する	はっぴょうする 	phát biểu, thông báo	[PHÁT BIỂU]
兄弟	きょうだい 	anh em	[HUYNH ĐỆ]
大げんか	おおげんか 	cải nhau lớn	[ĐẠI]
絶交	ぜっこう 	tuyệt giao, chấm dứt quan hệ	[TUYỆT GIAO]
負ける	まける 	thua	[PHỤ]
以来	いらい 	 sau khi	[DĨ LAI]
年賀状	ねんがじょう 	 thiệp mừng năm mới	[NIÊN HẠ TRẠNG]
やり取り	やりとり 	 trao đổi	[THỦ]
環境	かんきょう 	 môi trường	[HÒAN CẢNH]
シンポジウム		 hội nghị chuyên đề
参加する	さんかする 	 tham gia	[TAM, THAM GIA]
暖房	だんぼう 	 hệ thống sưởi, làm nóng	[NÕAN PHÒNG]
軽い	かるい 	 nhẹ	[KHINH]
胃	い 	bao tử	[VỊ]
隣	となり 	 bên cạnh	[LÂN]
覗く	のぞく 	nhìn trộm, liếc nhìn
夫婦	ふうふ 	 vợ chồng	[PHU PHỤ]
真っ最中	まっさいちゅう 	 giữa lúc cao trào	[CHÂN TỐI TRUNG, TRÚNG]
患者	かんじゃ 	bệnh nhân	[HOẠN GIẢ]
助ける	たすける 	 cứu giúp	[TRỢ]
努力	どりょく 	 nỗ lực	[NỖ LỰC]
契約書	けいやくしょ 	 hợp đồng	[KHẾ ƯỚC THƯ]
べきだ		phải 	must
断わる	ことわる 	 từ chối	[ĐÓAN]
引き受ける	ひきうける 	 đảm nhận, nhận 	 công việc... 	[DẪN THỤ]
責任	せきにん 	 trách nhiệm	[TRÁCH NHIỆM]
最後	さいご 	 cuối cùng	[TỐI HẬU]
全力	ぜんりょく 	 toàn lực	[TÒAN LỰC]
尽くす	つくす 	toàn tâm , toàn lực	[TẬN]
代表	だいひょう 	 đại biểu	[ĐẠI BIỂU]
証拠	しょうこ 	chứng cứ	[CHỨNG CỨ]
逮捕する	たいほする 	 bắt giữ	[ĐẤT BỘ]
食中毒	しょくちゅうどく 	 ngộ độc thức ăn	[THỰC TRUNG, TRÚNG ĐỘC]
刺身	さしみ 	 gỏi cá / Sasimi	[THÍCH THÂN]
指輪	ゆびわ 	 nhẫn	[CHỈ	SÁP, THÁP LUÂN]
大会	たいかい 	đại hội	[ĐẠI HỘI]
マラソン		maratông; môn chạy đường dài
完走	かんそう 	chạy tới đích	[HÒAN TẨU]
目指す	めざす 	 hướng tới, nhắm tới	[MỤC CHỈ	SÁP, THÁP]
強調	きょうちょう 	sự nhấn mạnh	[CƯỜNG, CƯỠNG	MiỄN ĐiỀU, ĐiỆU]
健康	けんこう 	sức khoẻ; tình trạng sức khoẻ	[KIỆN KHANG]
進学	しんがく 	 học lên đại học; học lên cao học	[TẤN, TIẾN HỌC]
限る	かぎる 	giới hạn; hạn chế	[HẠN]
贅沢	ぜいたく 	sự xa xỉ; xa hoa	[TRẠCH]
豊か	ゆたか 	phong phú; dư dật; giàu có	[PHONG]
味わう	あじわう 	nếm; thưởng thức; nhấm nháp	[VỊ]
アドバイス		lời khuyên; tư vấn
成功	せいこう 	thành công	[THÀNH CÔNG]
無駄遣い	むだづかい 	sự lãng phí tiền , tiêu xài phung phí	[VÔ THỒ KHIỂN. KHIẾN]
道路	どうろ 	con đường; con phố	[ĐẠO LỘ]
フリー		không mất tiền, được miễn phí, tự do
不規則	ふきそく 	không có quy tắc	[BẤT QUI TẮC]
覚悟する	かくごする 	chuẩn bị tinh thần; sẵn sàng	[GIÁC NGỘ]
励ます	はげます 	cổ vũ; làm phấn khởi; khích lệ	[LỆ]
無心	むしん 	sự vô tâm	[VÔ TĂM]
貧しい	まずしい 	điêu đứng; nghèo	[BẦN]
真実	しんじつ 	chân thật; thật sự	[CHÂN THỰC]
出勤	しゅっきん 	 sự đi làm; sự tới nơi làm việc	[XUẤT CẦN]
当事者	とうじしゃ 	đương sự; người có liên quan	[ĐANG, ĐƯƠNG SỰ GIẢ]
第三者	だいさんしゃ 	người thứ ba; người không liên quan	[ĐỆ TAM GIẢ]
期待	きたい 	sự kỳ vọng; sự hy vọng	[KỲ ĐÃI]
諦める	あきらめる 	từ bỏ; bỏ cuộc
流す	ながす 	cho chảy đi, làm chảy đi	[LƯU]
新幹線	しんかんせん 	tàu siêu tốc	[TÂN CÁN TUYẾN]
引っ越し	ひっこし 	dọn nhà, chuyển chỗ ở	[DẪN VIỆT]
資格	しかく 	bằng cấp	[TƯ CÁCH]
眠気	ねむけ 	cơn buồn ngủ	[MIÊN KHÍ]
選挙	せんきょ 	cuộc tuyển cử	[THIÊN	TUYỂN CỬ]
当選	とうせん 	đắc cử	[ĐANG, ĐƯƠNG THIÊN	TUYỂN]
支持者	しじしゃ 	người ủng hộ	[CHI TRÌ GIẢ]
応援	おうえん 	cổ vũ, ủng hộ	[ỨNG VIỆN, VIÊN]
怒る	おこる 	nổi giận	[NỘ]
大型	おおがた 	to lớn, quy mô lớn	[ĐẠI HÌNH]
大掃除	おおそうじ 	tổng vệ sinh	[ĐẠI TẢO TRỪ]
意志	いし 	ý chí	[Ý CHÍ]
影響	えいきょう 	ảnh hưởng	[ẢNH HƯỞNG]
風邪	ふうじゃ 	bị cảm , trúng gió	[PHONG TÀ]
濡れる	ぬれる 	ướt đẫm
家庭	かてい 	gia đình	[GIA ĐÌNH]
不満	ふまん 	bất mãn	[BẤT MÃN]
後悔	こうかい 	hối hận, hối tiếc	[HỐI CẢI]
ぐずぐずする		 lần chần, lưỡng lự
お前	おまえ 	mày
俺	おれ 	tao, tôi
学ぶ	まなぶ 	học	[HỌC]
益々	ますます 	ngày càng	[ÍCH]
発達	はったつ 	sự phát triển	[PHÁT ĐẠT]
路線	ろせん 	tuyến đường, lộ trình	[LỘ TUYẾN]
最新	さいしん 	sự tối tân; mới nhất	[TỐI TÂN]
著しい	いちじるしい 	đáng kể	[TRƯỚC, TRỨ]
気温	きおん 	nhiệt độ	[KHÍ ÔN]
競技	きょうぎ 	cuộc thi đấu; thi đấu; thi đ	[CẠNH KỸ]
一生懸命	いっしょうけんめい 	chăm chỉ; cần mẫn; cần cù	[NHẤT SINH HUYỀN MẠNG, MỆNH]
機関	きかん 	cơ quan	[CƠ QUAN]
非常	ひじょう 	phi thường; cực kỳ; đặc biệt	[PHI THƯỜNG]
がっかり		thất vọng; chán nản
久しぶり	ひさしぶり 	lâu rồi 	 không gặp	[CỬU]
長期	ちょうき 	thời gian dài; trường kỳ; dài	[TRƯỜNG, TRƯỞNG KỲ]
評価	ひょうか 	sự đánh giá	[BÌNH GIÁ]
一流	いちりゅう 	hạng nhất; hàng đầu; cao cấp	[NHẤT LƯU]
さすが		tốt; tuyệt; như mong đợi
首都	しゅと 	thủ đô	[THỦ ĐÔNG]
倒産	とうさん 	sự phá sản; sự không trả được	[ĐẢO SẢN]
失う	うしなう 	mất; đánh mất; bị tước; lỡ; bỏ	[THẤT]
勤める	つとめる 	làm việc; đảm nhiệm	[CẦN]
二酸化炭素	にさんかたんそ 	Khí các bô ních; CO2	[NHỊ TÁN HÓA THAN TỐ]
増加	ぞうか 	sự gia tăng; sự thêm vào	[TĂNG GIA]
引き続き	ひきつづき 	 tiếp tục; kế đến, tiep theo	[DẪN TỤC]
言い訳	いいわけ 	biện hộ; phân trần; biện bạch	[NGÔN DỊCH]
遅刻	ちこく 	sự muộn; sự đến muộn	[TRÌ KHẮC]
目覚まし時計	めざましどけい 	đồng hồ báo thức	[MỤC GIÁC]
当然な	とうぜんな 	đương nhiên; dĩ nhiên	[ĐANG, ĐƯƠNG NHIÊN]
義務	ぎむ 	nghĩa vụ; bổn phận	[NGHĨA VỤ]
決意	けつい 	 quyết định, quyết tâm	[QUYẾT Ý]
プロ		chuyên nghiệp
大幅に	おおはばに 	diện rộng	[ĐẠI BỨC]
信号	しんごう 	đèn hiệu; đèn giao thông	[TÍN HIỆU]
職場	しょくば 	nơi làm việc	[CHỨC TRƯỜNG, TRÀNG]
定休日	ていきゅうび 	ngày nghỉ thường kì	[ĐỊNH HƯU NHẬT]
通知	つうち 	sự thông báo; sự thông tri	[THÔNG TRI, TRÍ]
告知	こくち 	chú ý; thông cáo	[CÁO TRI, TRÍ]
工事中	こうじちゅう 	đang xây dựng; đang thi công	[CÔNG SỰ TRUNG, TRÚNG]
協力	きょうりょく 	sự hợp tác; hợp tác	[HIỆP LỰC]
好評	こうひょう 	tính phổ biến; được đánh giá cao	[HẢO, HIẾU BÌNH]
上映	じょうえい 	chiếu phim, công chiếu	[THƯỢNG ÁNH]
延長	えんちょう 	sự kéo dài	[DIÊN TRƯỜNG, TRƯỞNG]
離れ	はなれ 	rời xa, cách xa	[LY]
旅する	たびする 	đi du lịch; du lịch; đi xa	[LỮ]
被害	ひがい 	thiệt hại	[BỊ HẠI]
王国	おうこく 	vương quốc;	[VƯƠNG QUỐC]
最強	さいきょう 	mạnh nhất	[TỐI CƯỜNG, CƯỠNG	MiỄN]
梅雨	つゆ 	mùa mưa	[MAI VŨ]
時期	じき 	thời kỳ	[THỜI, THÌ KỲ]
寝坊	ねぼう 	ngủ dậy muộn	[TẨM PHƯỜNG]
遭う	あう 	gặp phải 	tai nạn	[TAO]
渋滞	じゅうたい 	ùn tắc, kẹt xe	[SÁP TRỆ]
直る	なおる 	được chữa, được sửa	[TRỰC]
虫歯	むしば 	sâu răng, răng sâu	[TRÙNG XỈ]
解ける	とける 	mở ra, cởi ra	[GIẢI]
南極	なんきょく 	nam cực	[NAM CỰC]
上昇	じょうしょう 	tăng lên, tiến bộ	[THƯỢNG THĂNG]
満席	まんせき 	hết chỗ ngồi	[MÃN TỊCH]
素晴らしい	すばらしい 	tuyệt vời, tráng lệ	[TỐ TÌNH]
感動	かんどう 	cảm động	[CẢM ĐỘNG]
目標	もくひょう 	mục tiêu	[MỤC TIÊU]
合格	ごうかく 	trúng tuyển, thi đậu	[HỢP CÁCH]
進む	すすむ 	tiến lên, tiến bộ	[TẤN, TIẾN]
多忙	たぼう 	rất bận, bận rộn
逆説	ぎゃくせつ 	ý kiến ngược đời; nghịch biện	[NGHỊCH THUYẾT]
学習	がくしゅう 	sự học tập; sự học	[HỌC TẬP]
話し手	はなして 	người nói	[THOẠI THỦ]
主語	しゅご 	chủ từ；chủ ngữ	[CHỦ NGỮ]
起こす	おこす 	khởi đầu	[KHỞI, KHỈ]
煙草	たばこ 	thuốc lá	[YÊN THẢO]
吸う	すう 	hút 	thuốc	[HẤP]
いやいや		miễn cưỡng; gượng gạo	[PHỦ PHỦ]
任す	まかす 	giao phó, phó thác	[NHIỆM]
机	つくえ 	cái bàn	[KỶ]
勝つ	かつ 	thắng, chiến thắng	[THẮNG]
誘惑	ゆうわく 	sự quyến rũ; sự lôi cuốn	[DỤ HOẶC]
非難	ひなん 	sự trách móc; sự phê phán	[PHI NẠN]
軽蔑	けいべつ 	sự khinh miệt; sự khinh thường	[KHINH]
翻訳	ほんやく 	dịch; sự giải mã	[PHIÊN DỊCH]
状況	じょうきょう 	tình trạng; hoàn cảnh	[TRẠNG HUỐNG]
転校	てんこう 	chuyển trường	[CHUYỂN HIỆU]
苦労	くろう 	sự gian khổ; sự cam go	[KHỔ LAO]
慣れる	なれる 	quen với; trở nên quen với	[QUÁN]
専業	せんぎょう 	chuyên nghiệp	[CHUYÊN NGHIỆP]
主婦	しゅふ 	nội trợ	[CHỦ PHỤ]
株	かぶ 	cổ phiếu；	[CHÂU]
売買	ばいばい 	buôn bán	[MẠI MÃI]
お見舞い	おみまい 	tham bệnh	[KIẾN VŨ]
暮らす	くらす 	mưu sinh	[MỘ]
不景気	ふけいき 	khung hoảng kinh tế, kinh tế suy thoái	[BẤT CẢNH KHÍ]
けれども		nhưng, tuy nhiên
予想外	よそうがい 	 ngoài dự kiến	[DƯ TƯỞNG NGOẠI]
驚き	おどろき 	sự ngạc nhiên	[KINH]
待ち合わせ	まちあわせ 	hẹn gặp	[ĐÃI HỢP]
反対	はんたい 	phản đối	[PHẢN ĐỐI]
温暖化	おんだんか 	sự ấm lên, nóng lên	[ÔN NÕAN HÓA]
傾向	けいこう 	khunh hướng	[KHUYNH HƯỚNG]
越す	こす 	 vượt qua	[VIỆT]
不自由	ふじゆう 	tàn phế	[BẤT TỰ DO]
面会	めんかい 	cuộc gặp gỡ	[DIỆN HỘI]
締め切り	しめきり 	hạn cuối, deadline	[ĐẾ THIẾT]
傘を差す	かさをさす 	bung dù	[SAI]
高価な	こうかな 	đắt, mắc tiền	[CAO GIÁ]
掃除	そうじ 	quyét dọn nhà	[TẢO TRỪ]
財布	さいふ 	cái ví, bóp	[TÀI BỐ]
出場	しゅつじょう 	ra sân, tham gia , tham dự trận đấu	[XUẤT TRƯỜNG, TRÀNG]
残業	ざんぎょう 	làm thêm giờ, tăng ca	[TÀN NGHIỆP]
現れる	あらわれる 	xuất hiện	[HIỆN]
平日	へいじつ 	ngày thường	[BÌNH NHẬT]
授業中	じゅぎょうちゅう 	trong giờ học	[THỤ NGHIỆP TRUNG, TRÚNG]
居眠り	いねむり 	sự ngủ gật	[CƯ MIÊN]
苦手	にがて 	kém, yếu	[KHỔ THỦ]
材料	ざいりょう 	vật liệu, nguyên liệu	[TÀI LIỆU]
全く	まったく 	toàn bộ, tất cả	[TÒAN]
調査	ちょうさ 	sự điều tra	[ĐiỀU, ĐiỆU TRA]
信用	しんよう 	Lòng tin; sự tin tưởng;	[TÍN DỤNG]
冷たい	つめたい 	lạnh, lạnh lùng	[LÃNH]
田舎	いなか 	quên hương, nông thôn	[ĐiỀN XÁ]
極端	きょくたん 	cực đoan	[CỰC ĐOAN]
現代	げんだい 	hiện nay, hiên đại	[HIỆN ĐẠI]
大企業	だいきぎょう 	doanh nghiệp lớn	[ĐẠI XÍ NGHIỆP]
覚える	おぼえる 	thuộc, nhớ	[GIÁC]
記憶	きおく 	trí nhớ, ký ức	[KÝ ỨC]
周囲	しゅうい 	chu vi, vùng chung quanh	[CHU VI]
風穴	かざあな 	lỗ thủng, lối thoát, giải pháp	[PHONG HUYỆT]
真夏	まなつ 	giữa mùa hè	[CHÂN HẠ]
精神	せいしん 	tinh thần；tâm chí	[TINH THẦN ]
酸性雨	さんせいう 	mưa acid	[TOAN TÍNH, TÁNH VŨ]
年金	ねんきん 	tiền trợ cấp hưu hàng năm	[NIÊN KIM]
本来	ほんらい 	từ trước tới nay; từ lúc bắt đầu	[BẢN LAI]
段差	だんさ 	chỗ lồi lên, dốc	[ĐOẠN SAI]
自然	しぜん 	tự nhiên	[TỰ NHIÊN]
開発	かいはつ 	phát triển	[KHAI PHÁT]
破壊	はかい 	 phá hủy	[PHÁ HOẠI]
運動	うんどう 	vận động, chơi thể thao	[VẬN ĐỘNG]
迷惑	めいわく 	quấy rầy, làm phiền	[MÊ HOẶC]
実行	じっこう 	thi hành, chấp hành	[THỰC HÀNH, HÀNG, HẠNH]
転勤	てんきん 	chuyển chỗ làm	[CHUYỂN CẦN]
海外生活	かいがいせいかつ 	cuộc sống ở nước ngoài	[HẢI NGOẠI SINH HỌAT]
合う	あう 	hợp, phù hợp	[HỢP]
優勝	ゆうしょう 	vô địch	[ƯU THẮNG]
倍	ばい 	lần	[BỘI]
借金	しゃっきん 	tiền mượn, tiền vay	[TÁ KIM]
親戚	しんせき 	bà con thân thuộc; họ hàng	[THÂN THÍCH]
亡く	なく 	chết	[VONG]
整形	せいけい 	giải phẫn thẩm mỹ	[CHỈNH HÌNH]
手術	しゅじゅつ 	mổ; sự phẫu thuật	[THỦ THUẬT]
美しい	うつくしい 	đẹp; ưa nhìn; có duyên; xinh	[MỸ]
男性	だんせい 	đàn ông	[NAM TÍNH]
親友	しんゆう 	bạn thân	[THÂN HỮU]
争う	あらそう 	gây gổ; cãi nhau; chiến tranh	[TRANH]
タレント		tài năng trẻ; ngôi sao mới
聴く	きく 	nghe; lắng nghe	[THÍNH]
エアコン		máy điều hòa không khí
効く	きく 	có tác dụng; có hiệu quả	[HIỆU]
家事	かじ 	công việc gia đình; việc nội trợ	[GIA SỰ]
騒ぐ	さわぐ 	gây ồn ào; làm huyên náo	[TAO]
録画	ろくが 	 sự ghi hình, quay video	[LỤC HỌA, HOẠCH]
大国	たいこく 	nước lớn; cường quốc	[ĐẠI QUỐC]
たっぷり		 đầy ắp, đầy tràn; đầy đủ; 
予報	よほう 	dự báo	[DỰ BÁO]
脱ぐ	ぬぐ 	cởi 	quần áo, giày; bỏ 	mũ	[THÓAT]
皮膚病	ひふびょう 	bệnh ngoài da	[BÌ PHU BỆNH]
受験生	じゅけんせい 	thí sinh dự thi	[THỤ NGHIỆM SINH]
直前	ちょくぜん 	ngay trước khi	[TRỰC TIỀN]
程度	ていど 	Mức độ, Trình độ	[TRÌNH ĐỘ]
挙げる	あげる 	Nâng lên, đỡ lên, đưa ra 	ví dụ	[CỬ]
比較する	ひかくする 	So sánh	[TỶ GIẢO]
慣用的	かんようてき 	Thành ngữ	[QUÁN DỤNG ĐÍCH]
作物	さくもつ 	Hoa màu, cây trồng	[TÁC VẬT]
渋谷	しぶや 	Tên riêng	[SÁP CỐC]
都心	としん 	Trung tâm thành phố	[ĐÔNG TĂM]
外見	がいけん 	Bề ngoài	[NGOẠI KIẾN]
良子	よしこ 	Tên riêng	[LƯƠNG TỬ, TÝ]
町内会	ちょうないかい 	Hội nghị thành phố	[THĨNH NỘI HỘi]
羨ましい	うらやましい 	Thèm muốn, ghen tỵ
観光客	かんこうきゃく 	Khách du lịch	[QUAN QUANG KHÁCH]
落ち込む	おちこむ 	Buồn bã, suy sụp	[LẠC VÀO]
気分	きぶん 	Tâm tình; tâm tư; tinh thần	[KHÍ PHÂN]
講演	こうえん 	Bài giảng; bài nói chuyện	[GiẢNG DiỄN]
燃える	もえる 	Cháy, đốt, nung nóng	[NHIÊN]
桃	もも 	Quả đào	[ĐÀO]
初心者	しょしんしゃ 	Người bắt đầu, người mới học	[SƠ TĂM GiẢ]
余裕	よゆう 	Phần dư, phần thừa ra.	[DƯ DỤ]
輸出額	ゆしゅつがく 	Doanh số xuất khẩu	[DU XUẤT NGẠCH]
億	おく 	100 triệu	[ỨC]
ドル		Đô la
前年	ぜんねん 	Năm trước	[TIỀN NIÊN]
喫煙者	きつえんしゃ 	Người hút thuốc	[KHIẾT YÊN GIẢ]
非喫煙者	ひきつえんしゃ 	Người không hút thuốc	[PHI KHIẾT YÊN GIẢ]
肺がん	はいがん 	Ung thư phổi	[PHẾ]
率	りつ 	Tỷ lệ	[SUẤT]
罹る	かかる 	Bị 	bệnh
収入	しゅうにゅう 	Thu nhập	[THU NHẬP]
支出	ししゅつ 	Mức chi ra	[CHI XUẤT]
万能	まんのう 	Toàn năng; vạn năng	[VẠN NĂNG]
活動的な	かつどうてきな 	năng động	[HỌAT ĐỘNG ĐÍCH]
内向的な	ないこうてきな 	Sống nội tâm; hướng nội	[NỘI HƯỚNG ĐÍCH]
どちらかというと		Nói gì thì nói
海側	かいがわ 	Bờ biển	[HẢI TRẮC]
大雪	おおゆき 	Tuyết rơi dày	[ĐẠI TUYẾT]
太平洋	たいへいよう 	Thái bình dương	[THÁI BÌNH DƯƠNG]
晴天	せいてん 	Trời quang đãng	[TÌNH THIÊN]
メディア		Phương tiện truyền thông
一方的	いっぽうてき 	Phiến diện	[NHẤT PHƯƠNG ĐÍCH]
発信	はっしん 	Truyền tín hiệu; phát đi	[PHÁT TÍN]
人手不足	ひとでぶそく 	Sự thiếu nhân lực	[NHÂN THỦ BẤT TÚC]
相変わらず	あいかわらず 	Như bình thường; như mọi khi	[TƯƠNG, TƯỚNG BiẾN]
若者	わかもの 	Người trẻ tuổi	[NHƯỢC GIẢ]
読書離れ	どくしょばなれ 	Không ham thích đọc sách	[ĐỘC GIẢ LY]
俳優	はいゆう 	Diễn viên	[BÀI ƯU]
出演する	しゅつえんする 	Trình diễn; xuất hiện	[XUẤT DIỄN]
活躍	かつやく 	hoạt động nổi bật, tích cực	[HỌAT DŨNG	DƯỢC]
一人暮らし	ひとりくらし 	Sống một mình	[NHẤT NHÂN MỘ]
面倒	めんどう 	Phiền hà; quấy rầy; khó khăn; trở ngại	[DIỆN ĐẢO]
設備	せつび 	Trang thiết bị	[THIẾT BỊ]
利点	りてん 	Điểm có lợi	[LỢI ĐiỂM]
授業料	じゅぎょうりょう 	Tiền học phí	[THỤ NGHIỆP LIỆU]
楽器	がっき 	Nhạc cụ	[NHẠC, LẠC KHÍ]
演奏する	えんそうする 	Diễn tấu; trình diễn 	âm nhạc	[DIỄN TẤU, TÂU]
逆	ぎゃく 	Ngược lại; tương phản; trái ngược	[NGHỊCH]
地域	ちいき 	Khu vực; vùng	[ĐỊA VỰC]
じっくり		Kỹ lưỡng; kỹ càng; thong thả
南側	みなみがわ 	Bờ phía nam	[NAM TRẮC]
北側	きたがわ 	Bờ phía bắc	[BẮC TRẮC]
住宅街	じゅうたくがい 	Khu dân cư	[TRÚ TRẠCH NHAI]
正月	しょうがつ 	Năm mới; Tết	[CHÍNH NGUYỆT]
党	とう 	Đảng 	chính trị	[ĐẢNG]
法案	ほうあん 	Dự luật	[PHÁP ÁN]
賛成する	さんせいする 	Tán thành	[TÁN THÀNH]
全面的	ぜんめんてきな 	Mang tính toàn diện	[TÒAN DIỆN ĐÍCH]
田舎暮らし	いなかくらし 	Sống ở nông thôn	[ĐiỀN XÁ MỘ]
観光地	かんこうち 	địa điểm du lịch, ngắm cảnh	[QUAN QUANG ĐỊA]
例年	れいねん 	thường niên	[LỆ NIÊN]
委員会	いいんかい 	ủy viên công chức chính phủ	[ỦY VIÊN HỘI]
施設	しせつ 	Thiết bị, cơ sở vật chất	[THI, THÍ THIẾT]
後半	こうはん 	Hiệp hai; nửa sau	[HẬU BÁN]
平ら	たいら 	Bằng phẳng	[BÌNH]
山歩き	やまあるき 	Leo núi, hiking	[SƠN BỘ]
常に	つねに 	Lúc nào cũng, luôn luôn	[THƯỜNG]
与える	あたえる 	Gây ra;ban tặng; thưởng	[DƯ, DỰ]
感覚	かんかく 	Cảm giác	[CẢM GIÁC]
辺り	あたり 	Khu vực xung quanh	[BIÊN]
中心部	ちゅうしんぶ 	Phần trung tâm	[TRUNG, TRÚNG TĂM BỘ]
家賃	やちん 	tiền thuê nhà	[GIA NHẤN]
話題	わだい 	chủ đề, đề tài	[THOẠI ĐỀ]
慌ただしい	あわただしい 	bận rộn, bận túi bụi	[HỎANG]
酔っ払う	よっぱらう 	say rượu	[TÚY PHẤT]
才能	さいのう 	tài năng, năng khiếu	[TÀI NĂNG]
芸術家	げいじゅつか 	nghệ thuật gia, người làm nghệ thuật	[NGHỆ THUẬT GIA]
地位	ちい 	địa vị	[ĐỊA VỊ]
飼う	かう 	chăn, nuôi	[TỰ]
動機	どうき 	động cơ	[ĐỘNG CƠ]
迷う	まよう 	lúng túng, lạc lối , lạc đường	[MÊ]
繰り返する	くりかえする 	lặp đi lặp lại	[TẢO PHẢN]
交通整理	こうつうせいり 	chỉnh đốn giao thông	[GIAO THÔNG CHỈNH LÝ]
雑誌	ざっし 	tạp chí	[TẠP CHÍ]
積む	つむ 	chất, xếp, chồng chất	[TÍCH]
電器	でんき 	đồ điện	[ĐiỆN KHÍ]
牛乳	ぎゅうにゅう 	sữa bò	[NGƯU NHŨ]
切符	きっぷ 	vé	[THIẾT PHÙ]
面接	めんせつ 	phỏng vấn	[DIỆN TIẾP]
展示会	てんじかい 	cuộc triển lãm, cuộc trưng bày	[TRIỂN THỊ HỘI]
適当	てきとう 	tương thích,phù hợp	[THÍCH ĐANG, ĐƯƠNG]
開催	かいさい 	tổ chức	[KHAI THÔI]
貯金	ちょきん 	tiết kiệm tiền	[TRỮ KIM]
減る	へる 	suy giảm, giảm bớt	[GIẢM]
超高齢化社会になる	ちょうこうれいかしゃかいになる 	xã hội có xu hướng già đi 	tỉ lệ người cao tuổi cao	[SIÊU CAO LINH HÓA XÃ HỘI]
景気	けいき 	tình hình kinh tế	[CẢNH KHÍ]
回復する	かいふくする 	hồi phục, khôi phục	[HỒI PHỤC]
アトラクション		chương trình văn nghệ
遊園地	ゆうえんち 	khu vực vui chơi, khu vực giải trí	[DU VIÊN ĐỊA]
戻る	もどる 	quay lại, trở lại	[LỆ]
厳しい	きびしい 	hà khắc, khắt khe	[NGHIÊM]
狭い	せまい 	chật hẹp	[HIỆP]
やっばり		đương nhiên, rõ ràng	[THỈ TRƯƠNG]
変化	へんか 	Thay đổi	[BiẾN HÓA]
背	せ 	lưng	[BÔ?I, BỘI]
教育費	きょういくひ 	chi phí đào tạo, nuôi dưỡng	[GIÁO DỤC PHÍ]
年寄り	としより 	Người già	[NIÊN KÝ]
体力	たいりょく 	thể lực, sức khỏe	[THỂ LỰC]
低下	ていか 	giảm, kém đi, suy giảm	[ĐÊ HẠ]
記憶力	きおくりょく 	trí nhớ	[KÝ ỨC LỰC]
衰える	おとろえる 	yếu đi, suy nhược, suy tàn	[SUY]
近付く	ちかづく 	gần tới, gần đến	[CÂ?N PHÓ]
何だか	なんだか 	không hiểu vì sao , không hiểu sao	[HÀ]
わくわくする		hồi hộp
高齢	こうれい 	cao tuổi	[CAO LINH]
減少	げんしょう 	suy giảm, giảm bớt	[GIẢM THIỂU, THIẾU]
街	まち 	phố phưởng, phố xá	[NHAI]
活気	かっき 	sự hoạt bát, sự sôi nổi, đầy sức sống	[HỌAT KHÍ]
様子	ようす 	trạng thái	[DẠNG TỬ, TÝ]
向ける	むける 	hướng về phía, phù hợp với	[HƯỚNG]
辞める	やめる 	nghỉ 	việc	[TỪ]
対比する	たいひする 	so sánh	[ĐỐI TỶ]
対照	たいしょう 	Sự đối chiếu	[ĐỐI CHIẾU]
面	めん 	Khía cạnh; phương diện	[DIỆN]
都会	とかい 	Thành thị; thành phố	[ĐÔHộI]
成績	せいせき 	 thành tích	[THÀNH TÍCH]
例え	たとえ 	ví dụ, giả dụ	[LỆ]
犯人	はんにん 	hung thủ, phạm nhân	[PHẠM NHÂN]
のんびり		thong thả; thong dong
大好物	だいこうぶつ 	món ăn rất ưu thích	[HẢO, HIẾU VẬT]
不況	ふきょう 	kinh tế suy thoái	[BẤT HUỐNG]
転職	てんしょく 	chuyển việc	[CHUYỂN CHỨC]
売り上げ	うりあげ 	bán ra	[MẠI THƯỢNG]
伸びる	のびる 	kéo dài; lớn lên; lan ra	[THÂN]
当日	とうじつ 	 ngày hôm đó	[ĐANG, ĐƯƠNG NHẬT]
育ち	そだち 	nuôi nấng	[DỤC]
南国	なんごく 	các nước phía nam	[NAM QUỐC]
本物	ほんもの 	đồ thật	[BẢN VẬT]
ダイヤモンド		kim cương
郵便	ゆうびん 	bưu kiện, bưu phẩm	[BƯU TIỆN]
寮	りょう 	Ký túc xá	[LIÊU]
洗濯	せんたく 	Sự giặt giũ, sự gột rửa, sự tẩy rửa	[TiỂN TRẠC]
大変	たいへん 	Kinh khủng; dễ sợ; khủng khiếp; rất, quá	[ĐẠI BiẾN]
遊ぶ	あそぶ 	Chơi; đi chơi	[DU]
試験	しけん 	Kỳ thi; thi cử	[THÍ NGHIỆM]
ぶらぶら		đu đưa; không mục đích; nhàn rỗi; lờ đờ; đi tha thẩn; rong chơi; nhàn rỗi; đi dạo nhàn rỗi
連絡	れんらく 	Liên lạc	[LIÊN LẠC]
否定	ひてい 	phủ định	[PHỦ ĐỊNH]
登場	とうじょう 	xuất hiện	[ĐĂNG TRƯỜNG, TRÀNG]
リーダー		độc giả; người lãnh đạo
手拍子	てびょうし 	cẩu thả, bất cẩn	[THỦ PHÁCH TỬ, TÝ]
被災者	ひさいしゃ 	nạn nhân thiên tai	[BỊ TAI GIẢ]
ボランティア活動	ボランティアかつどう 	 công tác từ thiện	[HỌAT ĐỘNG]
苦い	にがい 	đắng	[KHỔ]
絶対	ぜったい 	tuyệt đối	[TUYỆT ĐỐI]
閉ざす	とざす 	bịt lại; bít lại；ngăn lại;	[BẾ]
満員	まんいん 	đông người; chật ních người	[MÃN VIÊN]
必死	ひっし 	quyết tâm, quyết tử, liều chết	[TẤT TỬ]
足を踏ん張る	あしをふんばる 	xuống tấn, trụ chân lại	[TÚC ĐẠP TRƯƠNG]
アルコール		cồn; rượu
勧める	すすめる 	khuyên	[KHUYẾN]
効果的	こうかてき 	Có hiệu quả, có hiệu lực	[HIỆU QUẢ ĐÍCH]
伝える	つたえる 	Truyền, truyền đạt.	[TRUYỀN, TRUYỆN]
肩	かた 	Vai, bờ vai	[KHIÊN]
凝る	こる 	Đông cứng, đông lại	[NGƯNG]
夜中	よなか 	Nửa đêm, ban đêm	[DẠ TRUNG, TRÚNG]
嫌い	きらい 	Đáng ghét; không ưa; không thích, ghét	[HIỀM]
不思議	ふしぎ 	kỳ quái, kỳ lạ	[BẤT TƯ NGHỊ]
最近	さいきん 	Gần đây, mới đây	[TỐI CÂ?N]
意識	いしき 	Ý thức	[Ý THỨC]
店長	てんちょう 	Chủ cửa hàng; người quản lý cửa hàng	[ĐiẾM TRƯỜNG, TRƯỞNG]
捨てる	すてる 	Vứt bỏ	[XẢ]
景色	けしき 	Cảnh sắc, phong cảnh	[CẢNH SẮC]
入院	にゅういん 	Nhập viện	[NHẬP ViỆN]
退屈	たいくつ 	 buồn tẻ; chán ngắt	[THÓAI KHUẤT]
地震	じしん 	Động đất	[ĐỊA CHẤN]
企業	きぎょう 	Xí nghiệp; doanh nghiệp	[XÍ NGHIỆP]
爆発	ばくはつ 	Sự bộc phát; vụ nổ lớn	[BỘC PHÁT]
消す	けす 	tắt, tẩy, xóa, dụi	[TIÊU]
朝起き	あさおき 	thức dậy sớm	[TRIỀU KHỞI, KHỈ]
磨く	みがく 	mài, dũa, làm bóng	[MA]
不安	ふあん 	không yên tâm; bất an	[BẤT AN, YÊN]
似合う	にあう 	 hợp; tương xứng; vừa	[TỰ HỢP]
停電	ていでん 	 cúp điện	[ĐÌNH ĐiỆN]
自家	じか 	 nhà của mình	[TỰ GIA]
発電	はつでん 	sự phát điện	[PHÁT ĐiỆN]
良質	りょうしつ 	chất lượng tốt	[LƯƠNG CHẤT]
上質	じょうしつ 	chất lượng tốt	[THƯỢNG CHẤT]
日本酒	にほんしゅ 	rượu Nhật	[NHẬT BẢN TỬU]
視聴率	しちょうりつ 	tỉ lệ người xem	[THỊ THÍNH SUẤT]
ピアニスト		người chơi đàn piano
不足	ふそく 	không đủ; không đầy đủ; thiếu;	[BẤT TÚC]
各駅停車	かくえきていしゃ 	tàu đỗ ở tất cả các ga	[CÁC DỊCH ĐÌNH XA]
サボる		trốn học; trốn việc
探す	さがす 	tìm kiếm, lục lọi	[THÁM]
アニメ		phim hoạt hình
田んぼ	たんぼ 	ruộng lúa, ruộng nước	[ĐiỀN]
角度	かくど 	Góc độ, khía cạnh, quan điểm	[GIÁC ĐỘ]
栄養	えいよう 	Dinh dưỡng	[VINH DƯỠNG]
交渉	こうしょう 	Đàm phán	[GIAO THIỆP]
世辞	せじ 	Tâng bóc, tán dương, ca tụng	[THẾ TỪ]
恵まれる	めぐまれる 	Được ban cho	[HUỆ]
記録	きろく 	Sự ghi chép, ghi lại	[KÝ LỤC]
推量	すいりょう 	Sự đoán, phỏng đoán	[SUY LƯỢNG]
根拠	こんきょ 	Nền tảng, căn cứ, đáy	[CĂN CỨ]
年配者	ねんぱいしゃ 	Bậc tiền bối	[NIÊN PHỐI GIẢ]
頼りない	たよりない 	Không đáng tin, không nhờ cậy được
跡	あと 	Dấu vết, dấu tích	[TÍCH]
桜が咲く	さくらがさく 	Hoa anh đào nở	[ANH TIẾU]
企画案	きかくあん 	Bảng kế hoạch	[XÍ HỌA, HOẠCH ÁN]
椅子	いす 	ghế; cái ghế	[TỬ, TÝ]
材質	ざいしつ 	chất liệu	[TÀI CHẤT]
ぴったり		vừa khít, khớp, vừa vặn
庭	にわ 	vườn, sân vườn	[ĐÌNH]
派手	はで 	lòe loẹt; màu mè; sặc sỡ	[PHÁI THỦ]
預かる	あずかる 	giữ, cất giữ	[DỰ]
信じる	しんじる 	tin tưởng; tin vào	[TÍN]
丸々	まるまる 	hoàn toàn	[HÒAN]
一個	いっこ 	một cái; một cục; một viên.	[NHẤT CÁ]
ジム		thể dục thẩm mỹ; phòng thể dục
筋トレ	きんトレ 	luyện tập cơ bắp 	 cử tạ...	[CÂN]
助詞	じょし 	trợ từ	[TRỢ TỪ]
限定	げんてい 	sự hạn định; sự hạn chế	[HẠN ĐỊNH]
軽視	けいし 	sự khinh thường; sự xem nhẹ	[KHINH THỊ]
価値	かち 	giá	[GIÁ TRỊ]
誕生日	たんじょうび 	ngày sinh nhật	[ĐẢN SINH NHẬT]
ウイスキー		rượu whisky
高熱	こうねつ 	sốt cao	[CAO NHIỆT]
納豆	なっとう 	đậu nành lên men	[NẠP ĐẬU]
首相	しゅしょう 	thủ tướng	[THỦ TƯƠNG, TƯỚNG]
語学力	ごがくりょく 	khả năng ngôn ngữ	[NGỮ HỌC LỰC]
立場	たちば 	lập trường	[LẬP TRƯỜNG, TRÀNG]
事故	じこ 	sự cố	[SỰ CỐ]
現場	げんば 	hiện trường	[HIỆN TRƯỜNG, TRÀNG]
新製品	しんせいひん 	sản phẩm mới	[TÂN CHẾ PHẨM]
看護師	かんごし 	y tá	[KHÁN HỘ SƯ]
老人	ろうじん 	người già	[LÃO NHÂN]
手段	しゅだん 	phương tiện	[THỦ ĐỌAN]
監督	かんとく 	đạo diễn	[GIAM, GIÁM ĐỐC]
採用	さいよう 	tuyển dụng	[THẢI DỤNG]
珍しい	めずらしい 	hiếm	[TRÂN]
後輩	こうはい 	hậu bối	[HẬU BỐI]
江戸時代	えどじだい 	thời đại Edo	[GIANG HỘ THỜI, THÌ ĐẠI]
素人	しろうと 	dân nghiệp dư	[TỐ NHÂN]
他人	たにん 	người khác	[THA NHÂN]
甘やかす	あまやかす 	nuông chiều	[CAM]
表面上	ひょうめんじょう 	vẻ bên ngoài	[BIỂU DIỆN THƯỢNG]
進行上	しんこうじょう 	tiến độ	[TẤN, TIẾN HÀNH, HÀNG, HẠNH THƯỢNG]
休憩	きゅうけい 	nghỉ giải lao	[HƯU KHẾ]
解決	かいけつ 	giải quyết	[GIẢI QUYẾT]
連絡先	れんらくさき 	địa chỉ liên hệ	[LIÊN LẠC TIÊN]
主張	しゅちょう 	chủ trương	[CHỦ TRƯƠNG]
判断	はんだん 	phán đoán	[PHÁN ĐÓAN]
得る	える 	lấy được, đoạt được, được	[ĐẮC]
検査	けんさ 	kiêm tra	[KIỂM TRA]
故障	こしょう 	sự hỏng	[CỐ CHƯỚNG]
昨晩	さくばん 	tối hôm qua	[TẠC VÃN]
二日酔い	ふつかよい 	nhức đầu vì say rượu hôm trước	[TÚY]
賛成	さんせい 	tán thành, phê chuẩn	[TOAN THÀNH]
要望	ようぼう 	lời thỉnh cầu, lời đề nghị	[YÊU, YẾU VỌNG]
給料	きゅうりょう 	lương	[CẤP LIỆU]
津波	つなみ 	sóng thần	[TÂN BA]
薬指	くすりゆび 	ngón tay đeo nhẫn	[DƯỢC CHỈ	SÁP, THÁP]
欠航する	けっこうする 	hoãn cung cấp dịch vụ	[KHUYẾT HÀNG]
後ろ姿	うしろすがた 	nhìn từ đằng sau	[HẬU TƯ]
漏れる	もれる 	rò rĩ	[LẬU]
秘密	ひみつ 	bí mật	[BÍ MẬT]
機械	きかい 	máy móc	[CƠ GIỚI]
嬉しい	うれしい 	hạnh phúc
笑顔	えがお 	mặt cười	[TiẾU NHAN]
生かす	いかす 	Phát huy; tận dụng	[SINH]	例えば： いかす
乾燥	かんそう 	Sự khô; sự khô hạn	[CAN TÁO]	例えば： かんそう
海水	かいすい 	Nước biển; nước mặn	[HẢI THỦY]	例えば： かいすい
シェフ		Đầu bếp; cheft
各国	かくこく 	Các nước; các quốc gia	[CÁC QUỐC]	例えば： かくこく
核兵器	かくへいき 	Vũ khí hạt nhân	[HẠCH BINH KHÍ]	例えば： かくへいき
保有	ほゆう 	sở hữu, chiếm giữ	[BẢO HỮU]	例えば： ほゆう
流行する	はやりする / りゅうこうする 	Sự lưu hành; thịnh hành	[LƯU HÀNH, HÀNG, HẠNH]	例えば： はやりする / りゅうこうする
インフルエンザ		Bệnh cúm; cảm cúm
汚染	おせん 	Sự ô nhiễm	[Ô NHIỄM]	例えば： おせん
広がる	ひろがる 	Lan ra; lan rộng	[QUẢNG]	例えば： ひろがる
国内	こくない 	Nội địa; trong nước	[QUỐC NỘI]	例えば： こくない
農薬	のうやく 	Thuốc trừ sâu	[NÔNG DƯỢC]	例えば： のうやく
気になる	きになる 	Lo ngại; lo lắng; băn khoăn; bực bội, bứt rứt; khó chịu; phiền phức	[KHÍ]	例えば： きになる
ネット		Net
オークション		Đấu giá; bán đấu giá
大小	だいしょう 	Kích cỡ	[ĐẠI TIỂU]	例えば： だいしょう
送別会	そうべつかい 	Buổi liên hoan chia tay	[TỐNG BIỆT HỘI]	例えば： そうべつかい
募集	ぼしゅう 	Sự chiêu tập; sự chiêu mộ; sự tuyển mộ	[MỘ TẬP]	例えば： ぼしゅう
天候	てんこう 	Tiết trời;thời tiết	[THIÊN HẬU]	例えば： てんこう
酷い	ひどい 	Tàn khốc; kinh khủng; tàn nhẫn	[KHỐC]	例えば： ひどい 
畑	はたけ 	Ruộng nương	[VƯỜN]	例えば： はたけ
出て行く	でていく 	Đi ra	[XUẤT HÀNH, HÀNG, HẠNH]	例えば： でていく
品物	しなもの 	Hàng hóa;	[PHẨM VẬT]	例えば： しなもの
古新聞	ふるしんぶん 	Báo cũ	[CỔ TÂN VĂN]	例えば： ふるしんぶん
古雑誌	ふるざっし 	Tạp chí cũ	[TẠP CHÍ]	例えば： ふるざっし
無料	むりょう 	Miễn phí	[VÔ LIỆU]	例えば： むりょう
沿う	そう 	Chạy dài; chạy theo suốt; dọc	[DUYÊN]	例えば： そう
盛ん	さかん 	Phổ biến; thịnh hành; phát đạt	[THỊNH]	例えば： さかん
葬式	そうしき 	Đám tang; lễ tang	[TÁNG THỨC]	例えば： そうしき
使用	しよう 	Sử dụng	[SỬ DỤNG]	例えば： しよう 
女優	じょゆう 	Nữ diễn viên	[NỮ ƯU]	例えば： じょゆう 
謝る	あやまる 	Xin lỗi, tạ lỗi	[TẠ]	例えば： あやまる
閉店	へいてん 	Đóng cửa cửa hàng	[BẾ ĐiẾM]	例えば： へいてん
我がまま	わがまま 	Ích kỷ, lợi ích bản thân	[NGÃ]	例えば： わがまま
作曲	さっきょく 	Sáng tác nhạc	[TÁC KHÚC]	例えば： さっきょく
天才	てんさい 	Thiên tài	[THIÊN TÀI]	例えば： てんさい
断定的	だんていてき 	Tính quyết định	[ĐÓAN ĐỊNH ĐÍCH]	例えば： だんていてき
モーツアルト		Mozart
ニーズ		Nhu cầu 	Need
ワクチン		Vắc xin 	Vaccine
フリーマーケット		Thị trường tự do 	Free market
記事	きじ 	Phóng sự, tin tức báo chí.	[KÝ SỰ]	例えば： きじ
写す	うつす 	In tráng 	 hình , sao chép	[TẢ]	例えば： うつす
税金	ぜいきん 	Thuế, tiền thuế.	[THUẾ KIM]	例えば： ぜいきん
保険料	ほけんりょう 	Phí bảo hiểm	[BẢO HiỂM LIỆU]	例えば： ほけんりょう
値下	ねさげ 	Giá giảm	[TRỊ HẠ]	例えば： ねさげ
上向き	うわむき 	Khuynh hướng đi lên 	khuynh hướng phát triển .	[THƯỢNG HƯỚNG]	例えば： うわむき
延期する	えんきする 	Hoãn lại, lui kì hẹn lại	[DIÊN KỲ]	例えば： えんきする
分厚い	ぶあつい 	Dày, nặng	[PHÂN HẬU]	例えば： ぶあつい
治療代	ちりょうだい 	Phí trí liệu	[TRỊ LiỆU ĐẠI]	例えば： ちりょうだい
発売	はつばい 	Sự bán ra, phát hành.	[PHÁT MẠI]	例えば： はつばい
バーゲン		Sự mua bán, sự mặc cả mua bán 
少子化	しょうしか 	Giảm tỉ lệ sinh, kế hoạch hóa.	[THIỂU, THIẾU TỬ, TÝ HÓA]	例えば： しょうしか
一泊	いっぱく 	Trọ lại một đêm	[NHẤT BẠC]	例えば： いっぱく
期間	きかん 	Thời kì; giai đoạn; thời hạn; kỳ hạn	[KỲ GIAN, GIÁN]	例えば： きかん
予想	よそう 	Sự báo trước; phán đoán	[DƯ TƯỞNG]	例えば： よそう
頃	ころ 	Khi; khoảng; lúc	[KHOẢNH]	例えば： ころ
昼食	ちゅうしょく 	Bữa ăn trưa	[TRÚ THỰC]	例えば： ちゅうしょく
治安	ちあん 	Trị an, an ninh	[TRỊ AN, YÊN]	例えば： ちあん
晴れ	はれ 	Trời nắng	[TÌNH]	例えば： はれ
トレーニング		Sự tập huấn; học tập; training
食料品	しょくりょうひん 	Thực phẩm; nguyên liệu nấu ăn	[THỰC LIỆU PHẨM]	例えば： しょくりょうひん
商店	しょうてん 	Cửa hàng buôn bán; cửa hiệu	[THƯƠNG ĐiẾM]	例えば： しょうてん
都内	とない 	Khu vực thủ đô	[ĐÔNG NỘI]	例えば： とない
北海道	ほっかいどう 	Hokkaido 	Địa danh	[BẮC HẢI ĐẠO]	例えば： ほっかいどう
沖縄	おきなわ 	Okinawa 	Địa danh	[XUNG, TRÙNG THẰNG]	例えば： おきなわ
送料	そうりょう 	Cước phí gửi hàng	[TỐNG LIỆU]	例えば： そうりょう
地元	じもと 	Địa phương; trong vùng	[ĐỊA NGUYÊN]	例えば： じもと
経営	けいえい 	Kinh doanh, buôn bán	[KINH DOANH, DINH]	例えば： けいえい
相談	そうだん 	Thảo luận, trao đổi	[TƯƠNG, TƯỚNG ĐÀM]	例えば： そうだん
有らゆる	あらゆる 	Tất cả; mỗi; mọi	[HỮU]	例えば： あらゆる
奴	やつ 	gã ấy, thằng ấy	[NÔ]	例えば： やつ
裏	うら 	bề trái	[LÝ]	例えば： うら
防犯	ぼうはん 	Sự phòng chống tội phạm	[PHÒNG PHẠM]	例えば： ぼうはん
ブラウス		Áo cánh; áo sơ mi tay bồng; áo bờ	lu
溜まる	たまる 	đọng lại, ứ lại, dồn lại
只	ただ 	miễn phí
異文化	いぶんか 	nền văn hóa khác nhau	[DỊ VĂN HÓA]	例えば： いぶんか
迫力	はくりょく 	sức lôi cuốn, sức quyến rũ	[BÁCH LỰC]	例えば： はくりょく
パート			công việc bán thời gian
残業する	ざんぎょうする 	làm thêm, làm ngoài giờ	[TÀN NGHIỆP]	例えば： ざんぎょうする
定価	ていか 	giá xác định, giá ghi trên hàng hóa	[ĐỊNH GIÁ]	例えば： ていか
バーゲンセール		đại hạ giá
遠慮する	えんりょする 	dè dặt, làm khách, ngượng ngùng	[VIỄN LỰ]	例えば： えんりょする
古里	ふるさと 	quê hương, nơi chôn nhau cắt rốn	[CỔ LÝ]	例えば： ふるさと
瀬戸内海	せとないかい 	biển ở sâu trong nội địa	[LẠI HỘ NỘI HẢI]	例えば： せとないかい
労働	ろうどう 	lao động	[LAO ĐỘNG]	例えば： ろうどう
感性	かんせい 	cảm tính, tình cảm	[CẢM TÍNH]	例えば： かんせい
落とす	おとす 	đánh rơi	[LẠC]	例えば： おとす
慌てる	あわてる 	vội vàng, luống cuống, bối rối	[HỎANG]	例えば： あわてる
曲	きょく 	ca khúc
事件	じけん 	sự kiện, sự việc	[SỰ KIỆN]	例えば： じけん
ドーム		tòa nhà mái tròn
対策	たいさく 	biện pháp, đối sách	[ĐỐI SÁCH]	例えば： たいさく
早急な	そうきゅうな 	khẩn cấp	[TẢO CẤP]	例えば： そうきゅうな 
確か	たしか 	Chính xác, xác thực	[XÁC]	例えば： たしか
性格	せいかく 	Tâm trạng, trạng thái, tính tình	[TÍNH CÁCH]	例えば： せいかく
滝	たき 	Thác nước	[LONG]	例えば： たき 
心臓	しんぞう 	Trái tim	[TĂM TẠNG]	例えば： しんぞう 
進歩	しんぽ 	Tiến bộ	[TẤN, TIẾN BỘ]	例えば： しんぽ 
誘う	さそう 	Mời, rủ rê	[DỤ]	例えば： さそう
親しい	したしい 	Thân thiết, đầm ấm	[THÂN]	例えば： したしい
混乱する	こんらんする 	Hỗn loạn; lộn xộn	[HỖN LOẠN]	例えば： こんらんする
分別	ぶんべつ 	Phân loại; phân tách; chia tách	[PHÂN BIỆT]	例えば： ぶんべつ
海外出張する	かいがいしゅっちょうする 	Công tác nước ngoài	[HẢI NGOẠI XUẤT TRƯƠNG]	例えば： かいがいしゅっちょうする
お買い上げ	おかいあげ 	Mua, thu mua	[MÃI THƯỢNG]	例えば： おかいあげ
保証期間	ほしょうきかん 	Thời hạn bảo đảm, thời gian bảo hành	[BẢO CHỨNG KỲ GIAN, GIÁN]	例えば： ほしょうきかん
殺人	さつじん 	Tên sát nhân; tên giết người	[SÁT, SÁI NHÂN]	例えば： さつじん
玉子	たまご 	Trứng 	cá, ...	[NGỌC TỬ, TÝ]	例えば： たまご
パック		Bao gói
中止する	ちゅうしする 	Cấm; ngừng	[TRUNG, TRÚNG CHỈ]	例えば： ちゅうしする
月刊誌	げっかんし 	Tạp chí phát hành theo tháng	[NGUYỆT SAN CHÍ]	例えば： げっかんし
喫煙	きつえん 	Hút thuốc	[NGẠT, KHIẾT YÊN]	例えば： きつえん
各自	かくじ 	Mỗi; mỗi cái riêng rẽ;riêng; mỗi cá nhân	[CÁC TỰ]	例えば： かくじ
増す	ます 	Làm tăng lên	[TĂNG]	例えば： ます
飲み明かす	のみあかす 	Uống tới sáng	[ẨM MINH]	例えば： のみあかす
助言	じょげん 	Lời khuyên ,Lời hướng dẫn	[TRỢ NGÔN]	例えば： じょげん
譲る	ゆずる 	Nhường ,nhượng bộ	[NHƯỠNG]	例えば： ゆずる
温泉	おんせん 	Suối nước nóng	[ÔN TUYỀN]	例えば： おんせん
危ない	あぶない 	Nguy hiểm	[NGUY]	例えば： あぶない
言い換える	いいかえる 	Nói cách khác	[NGÔN HÓAN]	例えば： いいかえる
判定	はんてい 	Sự phán định; sự phân định	[PHÁN ĐỊNH]	例えば： はんてい
スタイル		Thân hình；kiểu cách; loại
センス		Cảm giác; cảm nhận
主食	しゅしょく 	Món chính	[CHỦ THỰC]	例えば： しゅしょく
記入する	きにゅうする 	Ghi vào; điền vào; viết vào	[KÝ NHẬP]	例えば： きにゅうする
ご存知	ごぞんじ 	Biết	[TỒN TRI, TRÍ]	例えば： ごぞんじ
踊る	おどる 	Ｎhảy múa
怒鳴る	どなる 	Gào lên; hét lên	[NỘ MINH]	例えば： どなる
散る	ちる 	Rơi; rụng	[TẢN, TÁN]	例えば： ちる
日常	にちじょう 	Ngày thường	[NHẬT THƯỜNG]	例えば： にちじょう
油	あぶら 	Dầu; mỡ rán	[DU]	例えば： あぶら
油っぽい	あぶらっぽい 	Béo ngậy; nhiều dầu mỡ	[DU]	例えば： あぶらっぽい
忘年会	ぼうねんかい 	Bữa tiệc cuối năm; bữa tiệc tổng kết cuối năm	[VONG NIÊN HỘI]	例えば： ぼうねんかい
予約	よやく 	Sự đặt trước; sự hẹn trước	[DƯ ƯỚC]	例えば： よやく
暮らし	くらし 	Cuộc sống; việc sinh sống	[MỘ]	例えば： くらし
交通事故	こうつうじこ 	Tai nạn giao thông	[GIAO THÔNG SỰ CỐ]	例えば： こうつうじこ
訳	わけ 	Lý do; nguyên nhân	[DỊCH]	例えば： わけ
道理	どうり 	Sự hợp lý; lý do; việc đúng với đạo lý	[ĐẠO LÝ]	例えば： どうり
事情	じじょう 	Tình hình; sự tình; lí do; nguyên cớ	[SỰ TÌNH]	例えば： じじょう
自給	じきゅう 	Sự tự lực	[TỰ CẤP]	例えば： じきゅう
納得	なっとく 	Đồng ý, lý giải	[NẠP ĐẮC]	例えば： なっとく
輸入品	ゆにゅうひん 	Hàng nhập khẩu	[DU NHẬP PHẨM]	例えば： ゆにゅうひん
塾	じゅく 	Trường tư thục	[THỤC]	例えば： じゅく
絵	え 	Tranh	[HỘI]	例えば： え
食欲	しょくよく 	thèm ăn	[THỰC DỤC]	例えば： しょくよく
生	なま 		bia tươi, sống, chưa chế biến	[SINH]	例えば： なま
素直	すなお 	sự thành thật, ngoan ngoãn	[TỐ TRỰC]	例えば： すなお
割引	わりびき 	 sự giảm giá	[CÁT DẪN]	例えば： わりびき
入場料	にゅうじょうりょう 	phí vào cửa	[NHẬP TRƯỜNG, TRÀNG LIỆU]	例えば： にゅうじょうりょう
海水魚	かいすいぎょ 	 cá nước mặn	[HẢI THỦY NGƯ]	例えば： かいすいぎょ
枝豆	えだまめ 	hạt còn xanh , chưa chín	[CHI ĐẬU]	例えば： えだまめ
海岸	かいがん 	 bờ biển	[HẢI NGẠN]	例えば： かいがん
土日	どにち 	 cuối tuần 	thứ 7 và chủ nhật	[THỔ NHẬT]	例えば： どにち
上級者	じょうきゅうしゃ 	người có đăng cấp cao	[THƯỢNG CẤP GIẢ]	例えば： じょうきゅうしゃ
締切	しめきり 	 hạn cuối, deadline	[ĐẾ THIẾT]	例えば： しめきり
有効	ゆうこう 	 có hiệu quả, 	IT valid, enable	[HỮU HIỆU]	例えば： ゆうこう
継続	けいぞく 	Sự tiếp tục, liên tục	[KẾ TỤC]	例えば： けいぞく
辛い	つらい 	Đau đớn, đau khổ, hà khắc	[TÂN]	例えば： つらい
従う	したがう 	Theo, căn cứ vào.	[TÔNG, TÙNG]	例えば： したがう
枯れる	かれる 	Héo, héo úa, héo tàn	[KHÔ]	例えば： かれる
別れる	わかれる 	Chia tay, ly biệt	[BIỆT]	例えば： わかれる
新型	しんがた 	Kiểu mới, dạng mới, mô hình mới	[TÂN HÌNH]	例えば： しんがた
常識	じょうしき 	Thông thường, thường thức	[THƯỜNG THỨC]	例えば： じょうしき
通用	つうよう 	Được áp dụng, lưu thông, lưu hành	[THÔNG DỤNG]	例えば： つうよう
点検	てんけん 	Kiểm điểm, kiểm tra	[ĐiỂM KIỂM]	例えば： てんけん
定期的	ていきてき 	Chu kỳ, định kỳ	[ĐỊNH KỲ ĐÍCH]	例えば： ていきてき
排気ガス	はいきガス 	Khí độc, khí thải	[BÀI KHÍ]	例えば： はいきガス
防止	ぼうし 	Đề phòng, ngăn ngừa	[PHÒNG CHỈ]	例えば： ぼうし
連続	れんぞく 	Liên tiếp, liên tục	[LIÊN TỤC]	例えば： れんぞく
フリーター		Freelance, Người làm tự do, làm bán thời gian
バイト		Làm thêm, việc làm không chính thức
ギャラ		Cát xê, tiền thù lao, tiền trả cho diễn viên
しっかり		Chắc chắn, ổn định
新鮮	しんせん 	Tươi, mới	[TÂN TIÊN]	例えば： しんせん
まわり		Sự quay
負担	ふたん 	Sự gánh vác, đảm nhận	[PHỤ ĐẢM]	例えば： ふたん
資金	しきん 	Tiền vốn	[TƯ KIM]	例えば： しきん
気力	きりょく 	Sinh lực, sức lực	[KHÍ LỤC]	例えば： きりょく
乗り越える	のりこえる 	Trèo lên, vượt lên	[THỪA VIỆT]	例えば： のりこえる
根性	こんじょう 	Bản tính, sự can đảm	[CĂN TÍNH]	例えば： こんじょう
ごちそう		Chiêu đãi, khao
農村	のうそん 	Nông thôn	[NÔNG THÔN]	例えば： のうそん
過疎	かそ 	Sự giảm dân số	[QUÁ SƠ]	例えば： かそ
外食	がいしょく 	Đi ăn ngoài, đi ăn tiệm	[NGOẠI THỰC]	例えば： がいしょく
野菜	やさい 	Rau	[DÃ THÁI]	例えば： やさい 
調節	ちょうせつ 	Điều tiết, điều chỉnh	[ĐiỀU, ĐiỆU TIẾT]	例えば： ちょうせつ
暖まる	あたたまる 	Ấm lên	[NÕAN]	例えば： あたたまる
演技	えんぎ 	Kỹ thuật trình diễn	[DIỄN KỸ]	例えば： えんぎ
加減	かげん 	Sự giảm, sự điều chỉnh	[GIA GIẢM]	例えば： かげん
病状	びょうじょう 	Bệnh tình, chứng bệnh	[BỆNH TRẠNG]	例えば： びょうじょう
治療	ちりょう 	Điều trị	[TRỊ LiỆU]	例えば： ちりょう 
提出	ていしゅつ 	Nộp bài	[ĐỀ XUẤT]	例えば： ていしゅつ
完壁	かんべき 	Hoàn thiện, toàn vẹn	[HÒAN BÍCH]	例えば： かんべき
迷子	まいご 	Đứa trẻ bị lạc	[MÊ TỬ, TÝ]	例えば： まいご
畳	たたみ 	Chiếu	[ĐiỆP]	例えば： たたみ
ニュアンス		Sắc thái
おまけ		Giảm giá
一歩	いっぽ 	Một bước	[NHẤT BỘ]	例えば： いっぽ
しかる		Quở trách; trách mắng
郵便物	ゆうびんぶつ 	Bưu phẩm	[BƯU TIỆN VẬT]	例えば： ゆうびんぶつ
乗り越す	のりこす 	Đi vượt qua	[THỪA, THẶNG VIỆT]
プライベート		Riêng tư; cá nhân
誤解	ごかい 	Hiểu lầm	[NGỘ	TẠ GIẢI]
継ぐ	つぐ 	Thừa kế; thừa hưởng; kế thừa	[KẾ]
意外	いがい 	Ngoài dự tính; ngoài dự kiến 	ngạc nhiên	[Ý NGOẠI]
反抗	はんこう 	Sự phản kháng	[PHẢN KHÁNG]	例えば： はんこう
兄妹	きょうだい 	Huynh muội, Anh trai em gái	[HUYNH MUỘI]	例えば： きょうだい
武力	ぶりょく 	Vũ lực	[VÕ, VŨ LỰC]	例えば： ぶりょく
指紋	しもん 	Vân tay ,dấu tay	[CHỈ	SÁP, THÁP VĂN]	例えば： しもん
好調	こうちょう 	Trạng thái tốt; tình hình tiến triển tốt	[HẢO, HIẾU ĐiỀU, ĐiỆU]	例えば： こうちょう
機器	きき 	Máy móc ,dụng cụ	[CƠ KHÍ]	例えば： きき
家電	かでん 	Đồ điện tử gia dụng	[GIA ĐiỆN]	例えば： かでん
滞在	たいざい 	Sự lưu lại ,tạm trú	[TRỆ TẠI]	例えば： たいざい
省略	しょうりゃく 	sự lược bỏ, giản lượt	[TỈNH LƯỢC]	例えば： しょうりゃく
赤札	あかふだ 	biển đỏ, phiếu giảm giá, biển giảm giá	[XÍCH TRÁT]	例えば： あかふだ
問い合わせ	といあわせ 	hỏi , điều tra	[VẤN HỢP]	例えば： といあわせ
警察	けいさつ 	cảnh sát, thám tử	[CẢNH SÁT]	例えば： けいさつ
実態	じったい 	tình hình thực tế, tình trạng thực tế	[THỰC THÁI]	例えば： じったい
利益	りえき 	Lợi ích, lợi nhuận	[LỢI ÍCH]	例えば： りえき
最優先	さいゆうせん 	Ưu tiên cao nhất	[TỐI ƯU TIÊN]	例えば： さいゆうせん
観客	かんきゃく 	Khán giả	[QUAN KHÁCH]	例えば： かんきゃく
投げる	なげる 	ném	[ĐẦU]	例えば： なげる
苦戦	くせん 	Chiến đấu gian khổ, khỏ chiến, lâm vào tình trạng khó khăn	[KHỔ CHIẾN]	例えば： くせん
日当たり	ひあたり 	hướng nắng	[NHẬT ĐANG, ĐƯƠNG]	例えば： ひあたり
後援	こうえん 	Bảo trợ, hậu thuẫn	[HẬU VIỆN, VIÊN]	例えば： こうえん
受け身文	うけみぶん 	Câu bị động	[THỤ THÂN VĂN]	例えば： うけみぶん
展示	てんじ 	Sự trưng bày	[TRIỂN THỊ]	例えば： てんじ
エネルギー		Năng lượng
消費量	しょうひりょう 	Lượng tiêu xài, Số tiền dùng vào việc gì đó	[TIÊU PHÍ LƯỢNG]	例えば： しょうひりょう
距離	きょり 	Khoảng cách, cự li	[CỰ LY]	例えば： きょり
値下げ	ねさげ 	Sự giảm giá, Sự bớt giá	[TRỊ HẠ]	例えば： ねさげ
不順に	ふじゅんに 	không thuận lợi , không tiến triển tốt...	[BẤT THUẬN]	例えば： ふじゅんに
トラブル		Rắc rối
国籍	こくせき 	Quốc tịch	[QUỐC TỊCH]	例えば： こくせき
眠れなく	ねむれなく 	Mất ngủ, Không ngủ được	[MIÊN]	例えば： ねむれなく
合否	ごうひ 	Thành công hay thất bại, đâu hay rớt	[HỢP PHỦ]	例えば： ごうひ
朝方	あさがた 	Cho đến sáng, tới sáng	[TRIỀU PHƯƠNG]	例えば： あさがた
積もる	つもる 	Chất; chất đống	[TÍCH]	例えば： つもる
流行る	はやる 	Lưu hành; thịnh hành	[LƯU HÀNH, HÀNG, HẠNH]	例えば： はやる
渡る	わたる 	Băng qua; đi qua	[ĐỘ]	例えば： わたる
長年	ながねん 	Nhiều năm	[TRƯỜNG, TRƯỞNG NIÊN]	例えば： ながねん
理性	りせい 	Lý tính; lý trí	[LÝ TÍNH]	例えば： りせい
新たな	あらたな 	Sự tươi; sự mới	[TÂN]	例えば： あらたな
多方面	たほうめん 	Nhiều mặt, nhiều phía , đa phương diện	[ĐA PHƯƠNG DIỆN]	例えば： たほうめん
表	おもて 	Biểu; bảng; bảng biểu	[BIỂU]	例えば： おもて
サイト		Site
パスワード		Mật khẩu, mật lệnh 	password
水道	すいどう 	Nước dịch vụ; nước máy	[THỦY ĐẠO]	例えば： すいどう
断水	だんすい 	Sự cắt nước; sự không cung cấp nước	[ĐÓAN THỦY]	例えば： だんすい
作家	さっか 	Tác giả; tác gia; cây bút	[TÁC GIA]	例えば： さっか
先立つ	さきだつ 	Đi trước; đứng trước; đặt trước; ở trước	[TIÊN LẬP]	例えば： さきだつ
マスコミ		Giới báo chí; phương tiện truyền thông đại chúng
撮影	さつえい 	Sự chụp ảnh	[TÓAT ẢNH]	例えば： さつえい
許可	きょか 	Sự cho phép; sự phê duyệt; sự chấp nhận	[HỨA KHẢ]	例えば： きょか
建設	けんせつ 	Sự kiến thiết; sự xây dựng	[KIẾN THIẾT]	例えば： けんせつ
住民	じゅうみん 	cư dân	[TRÚ DÂN]	例えば： じゅうみん
被害者	ひがいしゃ 	Nạn nhân; người bị hại	[BỊ HẠI GIẢ]	例えば： ひがいしゃ
氏名	しめい 	Họ tên	[THỊ, CHI DANH]
公表	こうひょう 	Sự công bố; sự tuyên bố	[CÔNG BIỂU]
プライバシー		sự riêng tư; cá nhân
配慮	はいりょ 	sự xem xét, sự cân nhắc	[PHỐI LỰ]
飲食	いんしょく 	Ăn uống;	[Ẩm THỰC]
禁止	きんし 	Sự cấm; sự cấm đoán; nghiêm cấm	[CẤM CHỈ]
禁煙	きんえん 	Cấm hút thuốc	[CẤM YÊN]
プラス		Sự thêm vào; cộng; dương 	plus 
加える	くわえる 	Thêm vào; gia tăng	[GIA]
通話	つうわ 	Sự gọi điện thoại	[THÔNG THOẠI]
通常	つうじょう 	Thông thường; thường thường	[THÔNG THƯỜNG]
ポイント		Điểm; điểm số 	point
セール		Sự bán hàng; sự bán ra; sự giảm giá
交代	こうたい 	Thay thế, thay phiên	[GIAO ĐẠI]
代行	だいこう 	Làm thay	[ĐẠI HÀNH, HÀNG, HẠNH]
広告	こうこく 	Quảng cáo	[QUẢNG CÁO]
応える	こたえる 	Trả lời, đáp ứng, nhận lời	[ỨNG]
和菓子	わがし 	Bánh kẹo Nhật	[HÒA, HỌA QUẢ TỬ, TÝ]
信頼	しんらい 	Sự tin cậy, tín nhiệm	[TÍN LẠI]
一同	いちどう 	Đồng loạt, nhất thể	[NHẤT ĐỒNG]
伸ばす	のばす 	Mở rộng, phát triển	[THÂN]
伴う	ともなう 	Cùng với, theo cùng,	[BẠN]
高齢者	こうれいしゃ 	Người lớn tuổi	[CAO LINH GIẢ]
矢印	やじるし 	Mũi tên	[THỈ ẤN]
採点	さいてん 	Chấm điểm	[THẢI ĐiỂM]
兼ねる	かねる 	kiêm nhiệm, kèm theo	[KIÊM]
出版	しゅっぱん 	Xuất bản	[XUẤT BẢN]
職人	しょくにん 	Người lao động, người thợ	[CHỨC NHÂN]
一つ一つ	ひとつひとつ 	Từng cái một	[NHẤT NHẤT]
媒介	ばいかい 	Môi giới, trung gian	[MÔI GIỚI]
当社	とうしゃ 	Công ty tôi đang làm	[ĐANG, ĐƯƠNG XÃ]
貢献する	こうけんする 	Cống hiến, đóng góp	[CỐNG HIẾN]
一生	いっしょう 	Cả đời, suốt đời, một đời	[NHẤT SINH]
巡る	めぐる 	Đi dạo, dạo quanh	[TUẦN]
死後	しご 	Sau khi chết, sau cái chết	[TỬ HẬU]
仲が悪い	なかがわるい 	Quan hệ không tốt, không thân thiện	[TRỌNG ÁC]
墓	はか 	Mồ, mã, huyệt, mộ	[MỘ]
記念碑	きねんひ 	Bia tưởng niệm, bia kỷ niệm	[KÝ NiỆM BI]
四季	しき 	4 mùa	[TỨ QÚI]
訴える	うったえる 	Kiện cáo, tố tụng	[TỐ]
怒り	いかり 	Giận dữ, tức giận	[NỘ]
サークル		Circle, đường tròn, hình tròn
契機	けいき 	cơ hội, động cơ	[KHẾ CƠ]
基礎	きそ 	 cơ sở, nền tảng	[CƠ SỞ]
知識	ちしき 	 kiến thức	[TRI, TRÍ THỨC]
改善	かいぜん 	 cải tiến, cải thiện	[CẢI THIỆN]
空手	からて 	Võ karate	[KHÔNG THỦ]
強化	きょうか 	 tăng cường, đẩy mạnh	[CƯỜNG, CƯỠNG	MiỄN HÓA]
定年	ていねん 	Về hưu	[ĐỊNH NIÊN]
故郷	ふるさと 	 quê nhà, cố hương	[CỐ HƯƠNG]
中高年	ちゅうこうねん 	 tuổi trung	cao niên	[TRUNG, TRÚNG CAO NIÊN]
高速道路	こうそくどうろ 	 đường cao tốc	[CAO TỐC ĐẠO LỘ]
金融	きんゆう 	Ngân hàng, tín dụng	[KIM DUNG]
鉄鋼	てっこう 	sắt thép,gang thép	[THIẾT CƯƠNG]
経済誌	けいざいし 	 tạp chí kinh tế	[KINH TẾ CHÍ]
激減	げきげん 	 giảm đi nhanh chóng	[KÍCH, KHÍCH GIẢM]
交換	こうかん 	Chuyển đổi	[GIAO HOÁN]
壁	かべ 	Bức tường	[BÍCH]
落書き	らくがき 	Sự viết nghệch ngoặc, viết ngoáy	[LẠC THƯ]
完璧	かんぺき 	Hoàn mỹ, toàn diện	[HOÀN BÍCH]
非婚	ひこん 	Không kết hôn	[PHI HÔN]
共働き	ともばたらき 	Việc cùng đi làm kiếm sống	[CỘNG ĐỌNG]
雇用	こよう 	sự thuê mướn	[CỐ DỤNG]
均等法	きんとうほう 	luật bình đẳng	[QUÂN ĐẲNG LUẬT]
上達	じょうたつ 	Sự tiến bộ	[THƯỢNG ĐẠT]
描く	かく 	tả, vẽ	[MIÊU]
優秀	ゆうしゅう 	sự ưu tú	[ƯU TÚ]
カメ		con rùa
堅苦しい	かたくるしい 	câu nệ hình thức, nghiêm túc, trang trọng	[KIÊN KHỔ]
早速	さっそく 	ngay lập tức	[TẢO TỐC]
診察券	しんさつけん 	Phiếu đăng kí khám bệnh	[CHẨN SÁT KHÓAN]
看護士	かんごし 	Y tá	[KHÁN HỘ SĨ]
求む	もとむ 	Tìm kiếm, yêu cầu, mong muốn	[CẦU]
勇気	ゆうき 	Can đảm, cứng rắn, dũng khí	[DŨNG KHÍ]
免許	めんきょ 	Sự cho phép, giấy phép, bằng cấp	[HỨA]
家具	かぐ 	Đồ trang trí nội thất, đồ đạc trong nhà	[GIA CỤ]
豊富	ほうふ 	Giàu có, phong phú	[PHONG PHÚ]
言葉遣い	ことばづかい 	Cách sử dụng từ ngữ, cách dùng từ, lời ăn tiếng nói	[NGÔN DIỆP KHIỂN. KHIẾN]
料金	りょうきん 	Tiền thù lao, tiền thưởng	[LIỆU KIM]
東西	とうざい 	Đông tây	[ĐÔNG TÂY]
接する	せっする 	Liên kết, tiếp nhận, giao tiếp	[TIẾP]
好む	このむ 	Thích; thích hơn; yêu thích	[HẢO, HIẾU]
踏む	ふむ 	Dẫm lên; trải qua	[ĐẠP]
来日	らいにち 	ngày hôm sau	[LAI NHẬT]
甘口	あまくち 	khéo nói, lời nịnh hót; lời ngon ngọt	[CAM KHẨU]
インテリア		Nội thất; nội địa; nội bộ
番組	ばんぐみ 	Chương trình tivi; kênh	[PHIÊN TỔ]
近寄る	ちかよる 	Tiếp cận; giao du	[CÂ?N KÝ]
貿易	ぼうえき 	Thương mại; ngoại thương; giao dịch	[MẬU DỊ, DỊCH]
黒字	くろじ 	Lãi; thặng dư	[HẮC TỰ]
他国	たこく 	Quốc gia khác; nước khác	[THA QUỐC]
批判	ひはん 	Phê phán; phê bình	[PHÊ PHÁN]
避ける	さける 	Tránh; trốn tránh; lảng tránh	[TỴ]
新鮮な	しんせんな 	Tươi; mới	[TÂN TIÊN]
温かい	あたたかい 	Ấm; ấm áp; nóng	[ÔN]
ペンキ		Sơn 	paint
塗る	ぬる 	Quét sơn; thoa; bôi; xoa	[ĐỒ]
ベンチ		Ghế dài; ghế ngồi 	ở công viên
炊く	たく 	Đun sôi; nấu sôi; nấu	[XUY]
揚げる	あげる 	Rán; chiên	[DƯƠNG]
産む	うむ 	Sinh; đẻ	[SẢN]
スプレー		Bình phun; bơm phun 	spray
容器	ようき 	Đồ đựng, đồ chứa	[DUNG KHÍ]
中身	なかみ 	Bên trong; nội dung	[TRUNG, TRÚNG THÂN]
一晩	ひとばん 	Một đêm; cả đêm; trọn đêm	[NHẤT VÃN]
逃げる	にげる 	Chạy; trốn chạy; thoát khỏi	[ĐÀO]
困難	こんなん 	Khó khăn; vất vả	[KHỐN NẠN]
餌	えさ 	Mồi; đồ ăn cho động vật; thức ăn gia súc gia cầm
野生	やせい 	hoang dã; dã sinh	[DÃ SINH]
だらしない		Bừa bộn; bừa bãi; lôi thôi
悲しい	かなしい 	Buồn; buồn bã	[BI]
寂しい	さびしい 	Buồn; cô đơn; cô quạnh	[TỊCH]
懐かしい	なつかしい 	Nhớ tiếc, hồi tưởng	[HÒAI]
怪しい	あやしい 	Đáng ngờ; khó tin	[QUÁI]
隠れる	かくれる 	Trốn; ẩn nấp	[ẨN]
詫び	わび 	Sự xin lỗi
定刻	ていこく 	thời khắc đã định	[ĐỊNH KHẮC]
到着	とうちゃく 	Sự đến; sự đến nơi	[ĐÁO TRƯỚC]
団体	だんたい 	Đoàn thể; tập thể	[ĐÒAN THỂ]
編む	あむ 	Đan; bện	[BIÊN]
セーター		Áo len chui đầu; áo len dài tay
焦る	あせる 	Sốt ruột; vội vàng; hấp tấp	[TIÊU]
ジャケット		Áo khoác; áo jac	ket
品	しな 	Đồ vật; hàng hóa	[PHẨM]
歯磨き粉	はみがきこ 	Kem đánh răng	[XỈ MA PHẤN]
皺	しわ 	Nếp nhăn; nếp gấp
見っともない	みっともない 	Đáng xấu hổ; khó coi; mất thể diện	[KIẾN]
アイロンかける		Ủi đồ
評判	ひょうばん 	Sự bình luận; lời bình luận	[BÌNH PHÁN]
興味	きょうみ 	Hứng thú	[HỨNG, HƯNG VỊ]
飽きる	あきる 	Chán ghét; mệt mỏi; không còn hứnng thú	[BÃO]
体調	たいちょう 	 tình trạng sức khỏe	[THỂ ĐiỀU, ĐiỆU]
行動	こうどう 	Hành động; sự hành động	[HÀNH, HÀNG, HẠNH ĐỘNG]
許す	ゆるす 	Tha lỗi; tha thứ; cho phép	[HỨA]
届く	とどく 	Đạt được	[GIỚI]
やはり		Đương nhiên; rõ ràng	[THỈ TRƯƠNG]
無事	ぶじ 	Bình an; vô sự	[VÔ SỰ]
冷暖房	れいだんぼう 	Máy lạnh	[LÃNH NÕAN PHÒNG]
調整	ちょうせい 	Điều chỉnh	[ĐiỀU, ĐiỆU CHỈNH]
弱点	じゃくてん	nhược điểm; điểm yếu	 NHƯỢC ĐIỂM
手形	てがた	hối phiếu	 THỦ HÌNH
仏像を刻む 彫る 彫刻 ちょうこく	ぶつぞうをきざむ	Khắc tượng phật 神仏 しんぶつ	 PHẬT TƯỢNG KHẮC ĐIÊU ĐIÊU KHẮC
体診 診る	みる	からだみ	chẩn đoán cơ thể	 THỂ CHẨN CHẨN
係	かかり	sự chịu trách nhiện	HỆ
備え付ける	そなえつける	lắp đặt; chuẩn bị sẵn; sẵn có	 BỊ PHÓ
備品	びひん	Trang thiết bị	 BỊ PHẨM
再生	さいせい	tái sinh, dùng lại	TÁI SINH
割増	わりまし	tiền thưởng, tiền trả thêm	CÁT TĂNG
医寮	いりょう	chữa trị	Y LIÊU
参集者	さんしゅうしゃ	Người tụ tập	 THAM/SÂM TẬP GIẢ
取り寄せる	とりよせる	Đặt hàng giao tận nơi	 THỦ KỲ
取り次ぐ	とりつぐ	1. chuyển giao 2. truyền đạt; chuyển tới	 THỦ THỨ
受付	うけつけ	quầy lễ tân	 THỤ/THỌ PHÓ
問いただす	といただす	gạn hỏi	 VẤN
夜間	やかん	thời gian buổi tối; vào buổi tuối; ban đêm	 DẠ GIAN
婦人	ふじん	phụ nữ	PHỤ NHÂN
安静（な）	あんせい（な）	nghỉ ngơi, yên tĩnh	AN TĨNH
定規	じょうぎ	thước kẻ	ĐỊNH QUY/QUI
実際に	じっさいに	thật là	THỰC TẾ
常識	じょうしき	kiến thức thông thường; bình thường	THƯỜNG THỨC
御中	おんちゅう	Quí 	công ty, kính thưa, kính gửi	 NGỰ TRUNG
快い	こころよい	Vui vẻ, dễ chịu, dễ thương	 KHOÁI
手当	てあて	chữa bệnh; trị bệnh; chữa trị	 THỦ ĐƯƠNG
手段	しゅだん	1. phương pháp 2. Thủ đoạn	 THỦ ĐOẠN
改正	かいせい	cải chính, chỉnh sửa	CẢI CHÍNH
日付	ひづけ	ngày tháng	NHẬT PHÓ
日月	にちげつ	Ngày tháng, năm tháng, mặt trăng và mặt trời	 NHẬT NGUYỆT
映像	えいぞう	hình ảnh	 ẢNH/ÁNH TƯỢNG
時刻	じこく	lúc, thời khắc	THỜI/THÌ KHẮC
時間割	じかんわり	thời gian biểu, thời gian làm việc và nghỉ ngơi	 THỜI/THÌ GIAN CÁT
検問	けんもん	Thanh tra, kiểm tra	 KIỂM VẤN
法令	ほうれい	luật lệ	 PHÁP LỆNH
流行	りゅうこう	thịnh hành, lưu hành	LƯU HÀNH
清い	きよい	Trong suốt, tinh khiết, nguyên chất	 THANH
清い流れ	きよいながれ	dòng nước trong	 THANH LƯU
清算	せいさん	thanh toán	 THANH TOÁN
準急	じゅんきゅう	Tàu tốc hành thường 	chậm hơn tàu tốc hành	 CHUẨN CẤP
点検	てんけん	Kiểm tra, xem xét kĩ lưỡng	 ĐIỂM KIỂM
為替	かわせ	hối đoái, ngân phiếu	 VI THẾ
片方	かたほう	một hướng; một chiều; một chiếc; một bên	 PHIẾN PHƯƠNG
特有	とくゆう	Riêng biệt, vốn có, cố hữu	 ĐẶC HỮU
発する	はっする	phát nguồn; khởi nguồn; bắt nguồn	 PHÁT
相違	そうい	sự khác nhau	 TƯƠNG/TƯỚNG VI
磁石	じしゃく	nam châm	TỪ THẠCH
立て札 改札口	たてふだ/ かいさつぐち	bảng thông báo/ cổng soát vé	 LẬP TRÁT CẢI TRÁT KHẨU
符号 寄付 切符	ふごう/きふ/ きっぷ	Ký hiệu, nhãn hiệu/đóng góp/vé	 PHÙ HIỆU KỲ PHÓ THIẾT PHÙ
第～	だい～	thứ ～ 	thứ 1, thứ 2, v.v...	 ĐỆ
緊急 緊張 大臣	きんきゅう	Khẩn cấp	 KHẨN CẤP KHẨN TRƯƠNG ĐẠI THẦN
線路	せんろ	đường ray, đường sắt	TUYẾN LỘ
縄 滝	たき 綿	めん/わた 紐（ひも）	なわ	dây thừng/ thác nước/sợi bông; vải bông; bông; cotton	 THẰNG LANG MIÊN
縄を解く 溶ける	とける 解く ほどく 結ぶ	なわをとく/ほどく	Mở dây thừng	 THẰNG GIẢI DUNG/DONG GIẢI KẾT
羽 溺れる	おぼれる	はね	cánh; lông vũ/ chết đuối; chìm đắm	 VŨ NỊCH
羽根 大根	だいこん	はね	Cánh, lông vũ	 VŨ CĂN ĐẠI CĂN
羽毛	うもう	Lông vũ	 VŨ MAO
落第	らくだい	Thất bại, thi trượt	 LẠC ĐỆ
視聴者 聴解	しちょうしゃ	Khán thính giả	 THỊ THÍNH GIẢ THÍNH GIẢI
計算 引き算	けいさん	tính, tính toán	KẾ TOÁN DẪN TOÁN
設置 設定 設ける	もうける	せっち	Bố trí, sắp đặt	 THIẾT TRÍ THIẾT ĐỊNH THIẾT
議論	ぎろん	thảo luận, tranh luận	NGHỊ LUẬN
貨幣	かへい	tiền, tiền tệ	 HÓA TỆ
賃金 賃貸	ちんたい	ちんぎん	Tiền công/ sự cho thuê	 NHẪM KIM NHẪM THẢI
転がる	ころがる	lăn; ngã; sụp đổ; đổ nhào	 CHUYỂN
転落	てんらく	rớt xuống, giáng chức	 CHUYỂN LẠC
適合 適当 指摘	してき	てきごう	thích hợp	 THÍCH HỢP/CÁP THÍCH ĐƯƠNG CHỈ TRÍCH
郵便 垂らす	たらす	ゆうびん	dịch vụ bưu điện	 BƯU TIỆN THÙY
郵送	ゆうそう	thư từ, thư tín	BƯU TỐNG
金銭	きんせん	tiền bạc	 KIM TIỀN
開放 妨げる	さまたげる	かいほう	Sự khai trương, Mở, để mở, cho mở	 KHAI PHÓNG PHƯƠNG
関わる	かかわる	liên quan, về	QUAN
険しい 試験 危険	けわしい	Dốc, hiểm trở, khắc nghiệt	 HIỂM THÍ NGHIỆM NGUY HIỂM
集会	しゅうかい	mitting	 TẬP HỘI
黒板 坂	さか	こくばん	bảng đen	 HẮC BẢN/BẢNG PHẢN
（～に）関する	（～に）かんする	về～, liên quan～	 QUAN
～の際	～のさい	khi～, lúc～	 TẾ
～付き	～つき	Với～	 PHÓ
～側	～がわ	bên, phía bên	 TRẮC
～内	～うち	trong ～	 NỘI
～化	～か	～ hóa 	biến đổi từ một cái gì đó sang cái khác	 HÓA
～号車	～ごうしゃ	toa xe số ~	HIỆU XA
～点	～てん	～ điểm	ĐIỂM
～番線	～ばんせん 	tuyến số ~	PHIÊN TUYẾN
～階	～かい	tầng ～	 GIAI
１万円札 立札	１まんえんさつ	tờ tiền 1 vạn yên	 VẠN VIÊN TRÁT LẬP TRÁT
ターミナル	ターミナル_terminal	bãi đỗ tàu xe; điểm cuối cùng của tàu xe	
トイレットペーパー	トイレットペーパー	Giấy vệ sinh	
トイレペーパー	トイレペーパー	giấy vệ sinh	
ベストセラー	ベストセラー	sự bán chạy nhất	
一段と	いちだんと		phó từ hơn rất nhiều, hơn một bậc	 NHẤT ĐOẠN
下線 アンダーライン	かせん	gạch chân	 HẠ TUYẾN
下降 降りる	かこう	Giảm xuống, sa sút, rơi xuống	 HẠ GIÁNG/HÀNG GIÁNG/HÀNG
不思議（な）	ふしぎ（な）	huyền diệu, kỳ ảo	BẤT TƯ NGHỊ
不自由（な）	ふじゆう（な）	không tự do, bị tàn phế	BẤT TỰ DO
両～	りょう～	cả hai ~	LƯỠNG/LƯỢNG
両側 側面	りょうがわ	hai bên	LƯỠNG/LƯỢNG TRẮC TRẮC DIỆN
両方	りょうほう	hai hướng, hai bên	LƯỠNG/LƯỢNG PHƯƠNG
両替	りょうがえ	đổi tiền	LƯỠNG/LƯỢNG THẾ
両目	りょうめ	đôi mắt ~	LƯỠNG/LƯỢNG MỤC
両親	りょうしん	cha mẹ, bố mẹ	LƯỠNG/LƯỢNG THÂN
主婦 主に	しゅふ	vợ	CHỦ PHỤ CHỦ
仏像 印象 画像 神仏 しんぶつ	ぶつぞう	Tượng phật	 PHẬT TƯỢNG ẤN TƯỢNG HỌA/HOẠCH TƯỢNG THẦN PHẬT
付近 切符	ふきん	Phụ cận,vùng lân cận	 PHÓ CẬN THIẾT PHÙ
以内	いない	trong vòng	DĨ NỘI
会議室	かいぎしつ	phòng họp, phòng hội nghị	HỘI NGHỊ THẤT
係員	かかりいん	người chịu trách nhiệm	 HỆ VIÊN
信号	しんごう	đèn giao thông	 TÍN HIỆU
側面 側	かわ/そば	そくめん	Mặt bên, sườn, phía cạnh	 TRẮC DIỆN TRẮC TRẮC
備える	そなえる	chuẩn bị, đề phòng	 BỊ
優しい	やさしい	hiền dịu, dịu dàng	ƯU
優れる	すぐれる	xuất sắc	ƯU
優先 優しい 優れる	ゆうせん	ưu tiên	 ƯU TIÊN ƯU ƯU
内	うち	trong, bên trong	 NỘI
内科 外科	ないか	khoa nội	NỘI KHOA NGOẠI KHOA
再び	ふたたび	lại, lần nữa	TÁI
再来年	さらいねん	năm sau nữa, hai năm nữa	TÁI LAI NIÊN
再診 診る	みる 初診	しょしん	さいしん	tái khám, khám lần sau	 TÁI CHẨN CHẨN SƠ CHẨN
出席 出欠	しゅっけつ 欠席 度	しゅっせき	có mặt, tham dự	XUẤT TỊCH XUẤT KHIẾM KHIẾM TỊCH ĐỘ
分割 割く	さく	ぶんかつ	phân cắt, chia	PHÂN CÁT CÁT
分店	ぶんてん	cửa hàng chi nhánh	 PHÂN ĐIẾM
切符	きっぷ	vé	THIẾT PHÙ
初	はつ/しょ		Hậu tố từ, xuất phát từ	 SƠ
初めて	はじめて	lần đầu tiên	SƠ
初恋	はつこい	mối tình đầu	SƠ LUYẾN
初診	しょしん	khám bệnh bước đầu, khám lần đầu	 SƠ CHẨN
初雪	はつゆき	đợt tuyết đầu tiên 	của mùa	SƠ TUYẾT
刻む 彫る	ほる 彫刻	ちょうこく	きざむ	1. đục, chạm 2. thái 	 rau, quả 	 KHẮC ĐIÊU ĐIÊU KHẮC
割り増し	わりまし	sự tăng thêm 	theo một tỷ lệ nào đó	 CÁT TĂNG
割れる 割く	さく	われる	vỡ, bể	CÁT CÁT
割引 割合 引き出す 弓 	ゆみ Cái cung	わりびき	giảm giá	CÁT DẪN CÁT HỢP/CÁP DẪN XUẤT CUNG
勝敗 敗れる	やぶれる	しょうはい	thắng bại	 THẮNG BẠI BẠI
包む 小包	こづつみ	つつむ	gói vào, bọc vào	BAO TIỂU BAO
包帯	ほうたい	Băng, đồ băng bó	 BAO ĐỚI/ĐÁI
化学	かがく	hóa học	HÓA HỌC
化粧室 花粉症	けしょうしつ	phòng trang điểm	HÓA TRANG THẤT HOA PHẤN CHỨNG
危うい	あやうい	nguy hiểm	 NGUY
危ない	あぶない	nguy hiểm	NGUY
危機	きき	Nguy cơ,mối hiểm hoạ	 NGUY CƠ/KY
危険（な） 試験	きけん（な）	nguy hiểm	NGUY HIỂM THÍ NGHIỆM
友達	ともだち	bạn bè	HỮU ĐẠT
受ける	うける	1. tham dự 	thi 2. tiếp thu, nhận	THỤ/THỌ
受験	じゅけん	dự thi, tham gia kỳ thi	 THỤ/THỌ NGHIỆM
同窓会	どうそうかい	Hội cựu sinh viên	 ĐỒNG SONG HỘI
喫煙所 契約	けいやく hd	きつえんじょ	chỗ hút thuốc, nơi hút thuốc	 KHIẾT YÊN SỞ KHẾ/KHIẾT ƯỚC
喫茶店	きっさてん	quán cà phê	 KHIẾT TRÀ ĐIẾM
営業 営む いとなむ	えいぎょう	kinh doanh, bán hàng	DOANH/DINH NGHIỆP DOANH/DINH
四捨五入 磁石 捨てる	ししゃごにゅう	Làm tròn	 TỨ SẢ NGŨ NHẬP TỪ THẠCH SẢ
国際	こくさい	quốc tế	QUỐC TẾ
地下鉄	ちかてつ	tàu điện ngầm, xe điện ngầm	 ĐỊA HẠ THIẾT
地点	ちてん	Địa điểm	 ĐỊA ĐIỂM
増える	ふえる	tăng lên	TĂNG
増加 増減	ぞうげん	ぞうか	gia tăng	TĂNG GIA TĂNG GIẢM
外科	げか	khoa ngoại	NGOẠI KHOA
妊娠 妊婦	にんぷ 振り返る	にんしん	có thai; có chửa	 NHÂM THẦN NHÂM PHỤ CHẤN PHẢN
妊婦 夫婦	ふうふ	にんぷ	Người mang thai	 NHÂM PHỤ PHU PHỤ
定休日	ていきゅうび	ngày nghỉ thường kì	ĐỊNH HƯU NHẬT
定員	ていいん	sức chứa	ĐỊNH VIÊN
定食 定める	さだめる	ていしょく	suất ăn	ĐỊNH THỰC ĐỊNH
家賃	やちん	tiền nhà, tiền thu nhà	GIA NHẪM
寄せる	よせる	kéo lại, đặt bên cạnh, cộng, tập trung lại	KỲ
寄付	きふ	Đóng góp, quyên góp	 KỲ PHÓ
小包	こづつみ	bưu kiện nhỏ	TIỂU BAO
席	せき	chỗ ngồi	TỊCH
常に	つねに		phó từ thường thường, luôn	THƯỜNG
年寄り 老人	ろうじん 老ける	ふける	としより	người già, người có tuổi	NIÊN KỲ LÃO NHÂN LÃO
座る	すわる	ngồi, ngồi xuống	TỌA
座席	ざせき	chỗ ngồi	TỌA TỊCH
引き算	ひきざん	phép trừ	DẪN TOÁN
御家族	ごかぞく	gia đình 	bạn	 NGỰ GIA TỘC
御手洗い	おてあらい	toa	lét, nhà vệ sinh	 NGỰ THỦ TẨY
快速	かいそく	Tốc độ cao, nhanh chóng	 KHOÁI TỐC
急病	きゅうびょう	bệnh cấp tính; bạo bệnh	 CẤP BỆNH
成る	なる	Trở nên,trở thành,lớn lên	 THÀNH
成人式	せいじんしき	Lễ Thành Nhân	 THÀNH NHÂN THỨC
成分 成果 果たす	はたす	せいぶん	thành phần	 THÀNH PHÂN THÀNH QUẢ QUẢ
押さえる	おさえる	giữ, bắt giữ	 ÁP
押し入れ	おしいれ	tủ âm tường	 ÁP NHẬP
押す	おす	ấn, nhấn, bấm	ÁP
指定席	していせき	ghế chỉ định	CHỈ ĐỊNH TỊCH
捨てる 四捨五入 拾う	ひろう	すてる	từ bỏ, vứt	 SẢ TỨ SẢ NGŨ NHẬP THẬP
掃く 清掃	せいそう	はく	quét, chải	TẢO THANH TẢO
改まる	あらたまる	cải biến, sửa đổi	CẢI
改める	あらためる	sửa đổi, cải thiện	CẢI
改札口 改善	かいぜん	かいさつぐち	cổng soát vé	CẢI TRÁT KHẨU CẢI THIỆN
放す	はなす	buông tay, rời tay	 PHÓNG
放送	ほうそう	phát thanh, loan truyền	PHÓNG TỐNG
放送局	ほうそうきょく	đài truyền hình, đài phát thanh	 PHÓNG TỐNG CỤC
救う 防ぐ	ふせぐ	すくう	cứu giúp, giúp đỡ	CỨU PHÒNG
救急 救う 求人 求める	きゅうきゅう	Cấp cứu, khẩn cấp	 CỨU CẤP CỨU CẦU NHÂN CẦU
文化 異文化 異なる	ぶんか	văn hóa	VĂN HÓA DỊ VĂN HÓA DỊ
新幹線	しんかんせん	tàu siêu tốc	TÂN CÁN TUYẾN
日常	にちじょう	ngày thường, thường ngày	NHẬT THƯỜNG
早速	さっそく	Ngay tức khắc, ngay lập tức	 TẢO TỐC
時速	じそく	tốc độ tính theo giờ	THỜI/THÌ TỐC
札	さつ	Thẻ, tờ, tiền giấy	 TRÁT
来訪 訪ねる	たずねる	らいほう	đến thăm	 LAI PHỎNG/PHÓNG PHỎNG/PHÓNG
来訪者	らいほうしゃ	Khách đến thăm	 LAI PHỎNG/PHÓNG GIẢ
板	いた	tấm ván; bảng	 BẢN/BẢNG
案	あん	Kế hoạch, đề án, ý kiến	 ÁN
案内	あんない	hướng dẫn, chỉ dẫn	ÁN NỘI
案内板 黒板	こくばん 板	あんないばん	bảng hướng dẫn	 ÁN NỘI BẢN/BẢNG HẮC BẢN/BẢNG BẢN/BẢNG
標準 表	ひょう/おもて	ひょうじゅん	tiêu chuẩn; hạn mức	 PHIẾU CHUẨN BIỂU
欠点 欠ける	かける	けってん	khuyết điểm	KHIẾM ĐIỂM KHIẾM
段	だん	giai đoạn	ĐOẠN
段階 皆	みんな 比べる 比較	ひかく	だんかい	giai đoạn	ĐOẠN GIAI GIAI TỶ/TỈ/BỈ TỶ/TỈ/BỈ GIÁC/HIỆU
水泳 凍える	こごえる	すいえい	việc bơi, bơi	 THỦY VỊNH ĐÔNG
水準	すいじゅん	Tiêu chuẩn, mức, trình độ	 THỦY CHUẨN
治療 治める	おさめる 寮	りょう	ちりょう	điều trị	TRỊ LIỆU TRỊ LIÊU
泳ぐ	およぐ	bơi, bơi lội	 VỊNH
洋食	ようしょく	đồ ăn Tây	 DƯƠNG THỰC
流す	ながす	cho chảy, cho chảy đi	 LƯU
流れる	ながれる	chảy, tôi chảy	LƯU
深い 欲深い	よくふかい 欲しい 谷	たに 容器	ようき	ふかい	dày, sâu	THÂM DỤC THÂM DỤC CỐC DUNG/DONG KHÍ
深刻（な） 彫刻	しんこく（な）	Trầm trọng, nghiêm trọng	 THÂM KHẮC ĐIÊU KHẮC
深夜 徹夜	てつや 撒く	まく 深刻	しんや	Nửa đêm, đêm khuya	 THÂM DẠ TRIỆT DẠ TÁT THÂM KHẮC
清掃 清い	きよい	せいそう	Quét dọn, dọn dẹp	 THANH TẢO THANH
清書	せいしょ	bản copy sạch	THANH THƯ
清流	せいりゅう	dòng nước trong	 THANH LƯU
温暖化 絞る	おんだんか	sự nóng lên toàn cầu	ÔN NOÃN HÓA GIẢO
港 涙 戻す	みなと	cảng	CẢNG LỆ LỆ
準備	じゅんび	chuẩn bị	CHUẨN BỊ
準決勝 決勝戦 	chung ket	じゅんけっしょう	trận bán kết	CHUẨN QUYẾT THẮNG QUYẾT THẮNG CHIẾN
点	てん	điểm	ĐIỂM
煙 煙い	けむい 煙たい	けむたい	けむり	khói	YÊN YÊN YÊN
理由 料理 軽油 自由	りゆう	lý do	LÝ DO LIỆU LÝ KHINH DU TỰ DO
産婦人科	さんふじんか	khoa sản, khoa phụ sản	SẢN PHỤ NHÂN KHOA
番号	ばんごう	số hiệu	PHIÊN HIỆU
異常	いじょう	không bình thường; dị thường	 DỊ THƯỜNG
疑わしい 疑問	うたがわしい	nghi ngờ; đáng ngờ; đáng nghi	 NGHI NGHI VẤN
発行	はっこう	phát hành	 PHÁT HÀNH
発達	はったつ	phát triển	PHÁT ĐẠT
皮	かわ	da, vỏ	BÌ
皮肉	ひにく	Mỉa mai, châm biếm	 BÌ NHỤC
皮膚	ひふ	Da,vỏ	 BÌ PHU
皮膚科	ひふか	khoa da liễu	 BÌ PHU KHOA
看板	かんばん	Bảng, bảng hiệu	 KHÁN BẢN/BẢNG
看病	かんびょう	Chăm sóc, trông nom	 KHÁN BỆNH
看護し 看病	かんごし	y tá	 KHÁN HỘ KHÁN BỆNH
着替える 着く	つく	きがえる	thay quần áo	TRƯỚC THẾ TRƯỚC
石	いし	đá, hòn đá	THẠCH
石段	いしだん	cầu thang đá	 THẠCH ĐOẠN
社内	しゃない	trong công ty	 XÃ NỘI
禁止 森林	しんりん	Rừng	きんし	cấm, nghiêm cấm	CẤM CHỈ SÂM LÂM
禁煙 煙い 煙たい	きんえん	cấm hút thuốc	CẤM YÊN YÊN YÊN
私鉄	してつ	đường sắt tư nhân, đường sắt tư doanh	 TƯ THIẾT
科学	かがく	khoa học	KHOA HỌC
空港	くうこう	sân bay	KHÔNG/KHỐNG CẢNG
窓	まど	cửa sổ	SONG
窓口	まどぐち	cửa bán vé	SONG KHẨU
立ち入り禁止	たちいりきんし	đi vào, xâm phạm, can thiệp	 LẬP NHẬP CẤM CHỈ
立ち寄る	たちよる	Ghé qua, ghé ngang	 LẬP KỲ
精神 神仏 仏	ほとけ	せいしん	Tâm trí, tâm hồn, tinh thần	 TINH THẦN THẦN PHẬT PHẬT
精算	せいさん	tính toán chính xác	TINH TOÁN
経由 軽油 Dầu nhẹ	けいゆ	Qua con đường, quá cảnh, sự thông qua 	 thủ tục 	 KINH DO KHINH DU
総合病院	そうごうびょういん	bệnh viện tổng hợp	 TỔNG HỢP/CÁP BỆNH VIỆN
総計	そうけい	Tổng cộng, tổng số	 TỔNG KẾ
落ちる	おちる	rơi, rụng	LẠC
落とす	おとす	đánh rơi, đánh rớt	LẠC
落石	らくせき	đá lở, đá lăn xuống	 LẠC THẠCH
薬局	やっきょく	hiệu thuốc	DƯỢC CỤC
診察	しんさつ	Khám bệnh	 CHẨN SÁT
診療 診る	しんりょう	khám chữa bệnh, chữa trị	 CHẨN LIỆU CHẨN
議員	ぎいん	nghị viện	 NGHỊ VIÊN
貯金	ちょきん	gửi tiền vào ngân hàng	TRỮ KIM
足し算	たしざん 	phép tính cộng	TÚC TOÁN
通路	つうろ	hành lang, lối đi	 THÔNG LỘ
速い 早速	はやい	nhanh chóng	TỐC TẢO TỐC
速達	そくたつ	chuyển phát nhanh	TỐC ĐẠT
遊ぶ	あそぶ	chơi, vui chơi	DU
遊泳 水泳 睡眠	ゆうえい	bơi	 DU VỊNH THỦY VỊNH THỤY MIÊN
運賃	うんちん	Cước chuyên chở, tiền xe tàu	 VẬN NHẪM
道路	どうろ	con đường	ĐẠO LỘ
郵便局	ゆうびんきょく	bưu điện	BƯU TIỆN CỤC
銀行口座	ぎんこうこうざ	tài khoản ngân hàng	NGÂN HÀNH KHẨU TỌA
閉じる	とじる	gấp, đóng 	sách 	 BẾ
閉まる	しまる	đóng, bị đóng chặt	BẾ
閉める	しめる	đóng	BẾ
閉会	へいかい	bế mạc hội nghị	BẾ HỘI
閉店	へいてん	đóng cửa hàng	BẾ ĐIẾM
閉店セール	へいてんセール	chấm dứt giảm giá	 BẾ ĐIẾM
開放厳禁	かいほうげんきん	Cấm mở cửa	 KHAI PHÓNG NGHIÊM CẤM
関係	かんけい	quan hệ	QUAN HỆ
関心	かんしん	quan tâm	QUAN TÂM
降りる	おりる	xuống 	 xe, núi 	 GIÁNG/HÀNG
降る	ふる	rơi 	mưa , đổ 	mưa	 GIÁNG/HÀNG
降車口	こうしゃぐち	Cửa dành để xuống xe	 GIÁNG/HÀNG XA KHẨU
階段	かいだん	cầu thang	 GIAI ĐOẠN
静か	な	しずか（な）	yên lặng	TĨNH
静まる	しずまる	lắng xuống, dịu đi	 TĨNH
非～	ひ～	không～	 PHI
非常に	ひじょうに	rất, cực kỳ	PHI THƯỜNG
非常口	ひじょうぐち	cửa thoát hiểm	PHI THƯỜNG KHẨU
音声	おんせい	âm thanh	 ÂM THANH
飛び出す	とびだす	chạy ra, nhảy ra	 PHI XUẤT
飛ぶ 飛び込む	とぶ	bay, nhảy	PHI PHI 	nhập
飛行場	ひこうじょう	sân bay, phi trường	PHI HÀNH TRƯỜNG
駐車	ちゅうしゃ	sự đỗ xe	TRÚ XA
駐車場	ちゅうしゃじょう	bãi đỗ xe, bãi đậu xe	TRÚ XA TRƯỜNG
完備	かんび	Trang bị đầy đủ	HÒAN BỊ
整備	せいび	Duy trì, bảo quản, sửa chữa	CHỈNH BỊ
調整	ちょうせい	điều chỉnh 	ĐiỀU, ĐiỆU CHỈNH
保つ	たもつ	Duy trì, bảo quản	BẢO
小児科	しょうにか	Khoa nhi	TIỂU NHI KHOA
換気	かんき	Thông gió, thông khí	HÓAN KHÍ
損害	そんがい	Thiệt hại	TỔN HẠI
未満	みまん	Ít hơn	VỊ, MÙI MÃN
法令	ほうれい	luật lệ; pháp lệnh, sắc lệnh	PHÁP LỆNH
満ちる	みちる	kết thúc; hết thời hạn	MÃN
災害	さいがい	Tai hoạ, tai ương	TAI HẠI
生存	せいぞん	Sinh tồn, sự sống	SINH TỒN
疾病	しっぺい	Bệnh tật	TẬT BỆNH
短編	たんぺん		truyện, tiểu thuyết ngắn 	ĐỎAN BIÊN
補償	ほしょう	Bồi thường, đền bù	BỔ THƯỜNG
賛美	さんび	tán dương; ca tụng	TOAN MỸ
～巻	～かん	quấn ~ 	QUYỂN
～未満	～みまん	không đủ～, không đầy ～	VỊ, MÙI MÃN
～済み	～ずみ	hoàn tất ~ 	TẾ
交通機関	こうつうきかん	Hệ thống giao thông, phương tiện giao thông	GIAO THÔNG CƠ QUAN
件名	けんめい	tiêu đề 	KIỆN DANH
修了	しゅうりょう	hoàn thành 	khóa học	TU LIỄU
修士	しゅうし	thạc sĩ 	TU SĨ
修正	しゅうせい	Sửa đổi, đổi lại	TU CHÍNH
修理	しゅうり	chỉnh lý, sửa chữa 	TU LÝ
停止	ていし	đình chỉ, dừng lại 	ĐÌNH CHỈ
冷ます	さます	làm lạnh, làm nguội 	LÃNH
冷やす	ひやす	làm lạnh đi 	LÃNH
冷静	れいせい	Bình tĩnh, điềm tĩnh	LÃNH TĨNH
出来事	できごと	Biến cố, sự kiện	XUẤT LAI SỰ
分量	ぶんりょう	liều lượng, phân lượng	PHÂN LƯỢNG
印	いん	cái dấu 	ẤN
印	しるし	Dấu hiệu, kí hiệu	ẤN
取材	しゅざい	Thu thập dữ liệu	THỦ TÀI
団地	だんち	Khu liên hợp nhà ở, khu chung cư	ĐÒAN ĐỊA
地帯	ちたい	Vùng, khu vực	ĐỊA ĐỚI, ĐÁI
変換	へんかん	sự biến đổi, hoán chuyển 	BiẾN HÓAN
完了	かんりょう	kết thúc 	HÒAN LIỄU
屋内	おくない	Trong phòng	ỐC NỘI
山登り	やまのぼり	leo núi 	SƠN ĐĂNG
巻く	まく	Cuộn lại, bọc lại	QUYỂN
帯	おび	đai, dây thắt lưng 	ĐỚI, ĐÁI
年老いた	としおいた	Tuổi già	NIÊN LÃO
幼い	おさない	Non dại	ẤU
幼児	ようじ	Đứa bé, đứa trẻ	ẤU NHI
支払機	しはらいき	máy thanh toán tiền 	CHI PHẤT CƠ
支持	"しじ	1. Duy trì 2. Ủng hộ, hậu thuẫn	CHI TRÌ"
整理券	せいりけん	số vé 	vé chỉnh sửa 	CHỈNH LÝ KHÓAN
書留	かきとめ	gửi đảm bảo 	THƯ LƯU
未～	み～	chưa ～	VỊ, MÙI
未知	みち	Chưa biết, xa lạ	VỊ, MÙI TRI, TRÍ
検討	けんとう	Thẩm tra, xem xét kĩ lưỡng	KIỂM THẢO
標本	ひょうほん	Mẫu	TIÊU BẢN
標準	ひょうじゅん	Tiêu chuẩn	TIÊU CHUẨN
浮かぶ	"うかぶ	1. trôi nổi; nổi lên,2. thoáng qua 	trong đầu	PHÙ"
浮かべる	"うかべる	1. thả trôi; làm nổi lên 2. mường tượng	PHÙ"
消える	きえる	tắt 	điện, tivi	TIÊU
湿気	しっけ	hơi ẩm, không khí ẩm thấp	THẤP KHÍ
満たす	みたす	Trút đầy, làm đầy, đổ đầy	MÃN
満員	まんいん	đầy người, đông người 	MÃN VIÊN
満足	まんぞく	thỏa mãn, hài lòng 	MÃN TÚC
照明	"しょうめい	1. ánh sáng; đèn 2. chiếu sáng	CHIẾU MINH"
片～	かた～	~ một chiều 	PHIẾN
用件	ようけん	việc 	DỤNG KIỆN
留守番電話	るすばんでんわ	Máy trả lời tự động	LƯU THỦ, THÚ PHIÊN ĐiỆN THOẠI
発券	はっけん	Phát hành trái phiếu	PHÁT KHÓAN
登場	とうじょう	xuất hiện 	sân khấu, ra 	sân khấu	ĐĂNG TRƯỜNG, TRÀNG
登山	とざん	leo núi 	ĐĂNG SƠN
目印	めじるし	dấu hiệu, mốc	MỤC ẤN
目当て	めあて	Mục đích, mục tiêu	MỤC ĐANG, ĐƯƠNG
目標	もくひょう	mục tiêu 	MỤC TIÊU
示す	しめす	xuất trình, đưa cho xem	THỊ
編集	へんしゅう	biên tập	BIÊN TẬP
肯定	こうてい	khẳng định	KHẲNG ĐỊNH
表現	ひょうげん	biểu hiện 	BIỂU HIỆN
規定	きてい	quy định, quy tắc 	QUI ĐỊNH
設備	せつび	thiết bị, trang thiết bị 	THIẾT BỊ
調子	ちょうし	tình trạng 	ĐiỀU, ĐiỆU TỬ, TÝ
賛成	さんせい	tán thành	TOAN THÀNH
返却	へんきゃく	Trả lại, hoàn trả	PHẢN KHƯỚC
通信	つうしん	tuyền thông, thông tin	THÔNG TÍN
通貨	つうか	Tiền tệ	THÔNG HÓA
違法	いほう	Trái phép, phạm luật	VI	VĨ PHÁP
鈍い	"にぶい	1. cùn 2. chậm	ĐỘN"
鋭い	するどい	sắc bén	NHUỆ
長編	ちょうへん		truyện, tiểu thuyết dài 	TRƯỜNG, TRƯỞNG BIÊN
除湿	じょしつ	Khử ẩm	TRỪ THẤP
風向	ふうこう	Hướng gió	PHONG HƯỚNG
～倍	～ばい	gấp～	BỘI
～枚	～まい	~ tờ 	đếm thư, giấy, tem 	MAI
～歳	～さい	～ tuổi 	TUẾ
お守り	おまもり	lá bùa	THỦ, THÚ
ごみ箱	ごみばこ	thùng rác 	SƯƠNG, TƯƠNG
ご存知	ごぞんじ	biết, hiểu, hiểu biết 	TỒN TRI, TRÍ
セーブ	セーブ	Save	
一般	いっぱん	cái chung	NHẤT BAN
中央	ちゅうおう	trung ương 	TRUNG, TRÚNG ƯƠNG
乗り換え	のりかえ	việc đổi xe	THỪA, THẶNG HÓAN
乗車券	じょうしゃけん	vé xe, vé hành khách 	THỪA, THẶNG XA KHÓAN
予備	"よび	dự bị Đồ dự phòng	DƯ BỊ"
予定	よてい	dự định 	DƯ ĐỊNH
予算	"よさん	dự toán Ngân sách, ngân quỹ	DƯ TOÁN"
予約	よやく	đặt trước, hẹn trước 	DƯ ƯỚC
予習	よしゅう	soạn bài 	DƯ TẬP
事件	じけん	Sự kiện, vụ việc	SỰ KIỆN
二十歳	はたち	20 tuổi 	NHỊ THẬP TUẾ
人類	じんるい	Nhân loại	NHÂN LOẠI
伝える	つたえる	truyền đạt, truyền lại 	TRUYỀN, TRUYỆN
伝言	でんごん	tin nhắn 	TRUYỀN, TRUYỆN NGÔN
体温計	たいおんけい	Nhiệt kế	THỂ ÔN KẾ
保存	ほぞん	bảo tồn 	BẢO TỒN
保守的	ほしゅてき	Bảo thủ	BẢO THỦ, THÚ ĐÍCH
保温	ほおん	giữ nhiệt, giữ độ ấm 	BẢO ÔN
保湿	ほしつ	Duy trì độ ẩm	BẢO THẤP
保留	ほりゅう 	bảo lưu, hoãn lại 	BẢO LƯU
保険	ほけん	Bảo hiểm, cam đoan	BẢO HiỂM
信じる	しんじる	tin tưởng, tin vào 	TÍN
倍	ばい	gấp đôi	BỘI
停留所	ていりゅうじょ	bến đỗ xe buýt 	ĐÌNH LƯU SỞ
停車	ていしゃ	Dừng xe	ĐÌNH XA
停電	ていでん	Cúp điện	ĐÌNH ĐiỆN
児童	じどう	Đứa bé, nhi đồng, thiếu nhi	NHI ĐỒNG
入学式	にゅうがくしき	lễ nhập học	NHẬP HỌC THỨC
全般	ぜんぱん	tổng quát, toàn bộ 	TÒAN BAN
公式	こうしき	Công thức	CÔNG THỨC
冷える	ひえる	lạnh đi, nguội đi 	LÃNH
冷たい	つめたい	lạnh, lạnh giá 	LÃNH
冷める	さめる	lạnh đi, nguội đi 	LÃNH
分店	ぶんてん	Cửa hàng chi nhánh	PHÂN ĐiẾM
分類	ぶんるい	phân loại 	PHÂN LOẠI
十円玉	じゅうえんだま	đồng tiền xu có trị giá 10 yên 	THẬP VIÊN NGỌC
印刷	いんさつ	In ấn	ẤN LOÁT
危機	きき	Nguy cơ, mối hiểm hoạ	NGUY CƠ
反する	はんする	trái lại; ngược nhau; đối nhau	PHẢN
反対	はんたい	ngược lại	PHẢN ĐỐI
取り消し	とりけし	loại bỏ 	THỦ TIÊU
取る	とる	lấy, cầm nắm	THỦ
受信箱	じゅしんばこ	hộp thư đến 	THỤ TÍN SƯƠNG, TƯƠNG
口紅	くちべに	son môi 	KHẨU HỒNG
可能（な）	かのう（な）	khả năng 	KHẢ NĂNG
向かい	むかい	hướng tới, đối diện với 	HƯỚNG
向こう	むこう	phía trước 	HƯỚNG
否定	ひてい	phủ định	PHỦ ĐỊNH
回復	かいふく	phục hồi 	HỒI PHỤC
回数券	かいすうけん	tập vé, quấn sổ vé 	HỒI SỐ KHÓAN
団体	だんたい	đoàn thể, tập thể 	ĐÒAN THỂ
基準	きじゅん	Tiêu chuẩn, nền tảng	CƠ CHUẨN
変える	かえる	đổi 	BiẾN
変わる	かわる	thay đổi 	BiẾN
大変（な）	たいへん（な）	vất vả, rất 	ĐẠI BiẾN
存在	そんざい	tồn tại 	TỒN TẠI
守る	まもる	tuân theo, gữ gìn 	THỦ, THÚ
完成	かんせい	hoàn thành 	HÒAN THÀNH
定期	ていき	định kì 	ĐỊNH KỲ
定期券	ていきけん	vé thường kỳ; vé tháng	ĐỊNH KỲ KHÓAN
対照	たいしょう		so sánh đối chiếu, Tương phản, trái ngược	ĐỐI CHIẾU
対照的	たいしょうてき	tính đối chiếu	ĐỐI CHIẾU ĐÍCH
履歴書	りれきしょ	sơ yếu lý lịch 	LÝ LỊCH THƯ
巻き戻し	まきもどし	Tua lại	QUYỂN LỆ
布団	ふとん	chăn, mền 	BỐ ĐÒAN
往復	おうふく	khứ hồi, cả đi cả về 	VÃNG PHỤC
復習	ふくしゅう	ôn tập 	PHỤC TẬP
戻る	もどる	quay lại, trở lại 	LỆ
手伝う	てつだう	giúp đỡ 	THỦ TRUYỀN, TRUYỆN
払い戻し	はらいもどし	hoàn trả 	 tiền 	PHẤT LỆ
払う	はらう	trả, trả tiền 	PHẤT
拡大	かくだい	Mở rộng, bành trướng	KHUẾCH ĐẠI
拾う	ひろう	lượm	THẬP
指	ゆび	ngón tay 	CHỈ	SÁP, THÁP
指す	さす	giương 	ô , giơ 	tay	CHỈ	SÁP, THÁP
指定席	していせき	ghế chỉ định, ghế đã đặt trước 	CHỈ	SÁP, THÁP ĐỊNH TỊCH
指示	しじ	chỉ thị 	CHỈ	SÁP, THÁP THỊ
掃除	そうじ	dọn dẹp, quét dọn 	TẢO TRỪ
掲示	けいじ	Thông báo	YẾT THỊ
携帯電話	けいたいでんわ	điện thoại di động 	HUỀ ĐỚI, ĐÁI ĐiỆN THOẠI
支える	ささえる	nâng đỡ, đỡ 	CHI
支店	してん	cửa hàng chi nhánh 	CHI ĐiẾM
支払う	しはらう	chi trả 	CHI PHẤT
数を数える	かずをかぞえる	đếm số lượng 	SỐ SỐ
数字	すうじ	chữ số, con số	SỐ TỰ
数学	すうがく	toán học, số học 	SỐ HỌC
数量	すうりょう	Số lượng, khối lượng	SỐ LƯỢNG
整う	ととのう	Được chuẩn bị	CHỈNH
新緑	しんりょく	Màu xanh của cây cỏ	TÂN LỤC
新規	しんき	Mới lạ, mới mẻ	TÂN QUI
旅券	りょけん	Hộ chiếu	LỮ KHÓAN
日本式	にほんしき	kiểu nhật 	NHẬT BẢN THỨC
明確（な）	めいかく（な）	sự rõ ràng và chính xác 	MINH XÁC
映像	えいぞう	hình ảnh 	ÁNH TƯỢNG
時刻表	じこくひょう	thời khóa biểu 	THỜI, THÌ KHẮC BIỂU
普段（の）	ふだん（の）	bình thường, thường thường 	PHỔ ĐỌAN
普通	ふつう	phổ thông, thông thường 	PHỔ THÔNG
暖かい	あたたかい	nóng, ấm áp 	NÕAN
暖房	だんぼう	lò sưởi 	NÕAN PHÒNG
書き取り	かきとり	viết chính tả 	THƯ THỦ
書式	しょしき	Định dạng	THƯ THỨC
書類	しょるい	tài liệu, giấy tờ 	THƯ LOẠI
期間	きかん	kì, thời kì 	KỲ GIAN, GIÁN
未定	みてい	Chưa quyết định, chưa chắc chắn	VỊ, MÙI ĐỊNH
未来	みらい	tương lai gần 	VỊ, MÙI LAI
枚数	まいすう	số tờ, số tấm 	MAI SỐ
機能	きのう	chức năng, tính năng 	CƠ NĂNG
欧米	おうべい	Âu mỹ	ÂU MỄ
正式	せいしき	Trang trọng, chính thức	CHÍNH THỨC
歴史	れきし	lịch sử 	LỊCH SỬ
残す	のこす	chừa lại, để lại 	TÀN
残る	のこる	còn lại, sót lại 	TÀN
残高照会	ざんだかしょうかい	vấn tin số dư 	TÀN CAO CHIẾU HỘI
水準	すいじゅん	Tiêu chuẩn, mức độ, trình độ	THỦY CHUẨN
水玉	みずたま	chấm tròn 	trên vải 	THỦY NGỌC
決まる	きまる	quyết định 	QUYẾT
決める	きめる	quyết, quyết định 	QUYẾT
決定	けってい	quyết định 	QUYẾT ĐỊNH
沈む	"しずむ 	1. chìm; đắm 2. buồn bã; đau khổ	TRẦM"
浮く	うく	nổi; lơ lửng	PHÙ
消しゴム	けしゴム	tẩy, cục tẩy 	TIÊU
消す	けす	tắt, xóa	TIÊU
消去	しょうきょ	Loại bỏ	TIÊU KHỬ, KHỨ
済む	すむ	kết thúc, hoàn tất 	TẾ
温かい	あたたかい	ấm, ấm áp 	ÔN
温室	おんしつ	nhà kính 	ÔN THẤT
温帯	おんたい	ôn đới 	ÔN ĐỚI, ĐÁI
温度	おんど	nhiệt độ 	ÔN ĐỘ
温暖（な）	おんだん（な）	ấm, ấm áp 	ÔN NÕAN
湿る	しめる	ẩm ướt	THẤP
湿度	しつど	Độ ẩm	THẤP ĐỘ
点数	てんすう 	điểm số 	ĐiỂM SỐ
照らす	てらす	Soi sáng, chiếu rọi	CHIẾU
片付ける	かたづける	dọn dẹp 	PHIẾN PHÓ
片道切符	かたみちきっぷ	vé một chiều 	PHIẾN ĐẠO THIẾT PHÙ
玉	たま	hạt ngọc, đồng tiền xu	NGỌC
現れる	あらわれる	xuất hiện; lộ ra	HIỆN
現像	げんぞう	rửa phim	HIỆN TƯỢNG
現金	げんきん 	tiền mặt 	HIỆN KIM
画像	がぞう	hình ảnh, hình tượng 	HỌA, HOẠCH TƯỢNG
留学	りゅうがく	du học 	LƯU HỌC
留守	るす 	vằng nhà 	LƯU THỦ, THÚ
発表	はっぴょう	phát biểu 	PHÁT BIỂU
登録	とうろく	đăng ký 	ĐĂNG LỤC
着信履歴	ちゃくしんりれき	lịch sử cuộc gọi 	TRƯỚC TÍN LÝ LỊCH
破片	はへん	Mảnh vụn, mảnh vỡ	PHÁ PHIẾN
硬い	かたい	cứng, cứng rắn 	NGẠNH
硬貨	こうか	Đồng tiền, tiền đồng	NGẠNH HÓA
確か（な）	たしか（な）	chính xác 	XÁC
確かめる	たしかめる	sự xác nhận, làm cho rõ ràng 	XÁC
確定	かくてい	Xác định, quyết định	XÁC ĐỊNH
確認	かくにん	xác nhận 	XÁC NHẬN
約～	やく～	ước khoảng ~ 	ƯỚC
約束	やくそく	lời hứa, quy ước 	ƯỚC THÚC
紅茶	こうちゃ	hồng trà, trà đen 	HỒNG TRÀ
終了	しゅうりょう	kết thúc việc gì đó, hoàn thành 	CHUNG LIỄU
緑（色）	みどり（いろ）	xanh, xanh lá cây 	LỤC SẮC
緑茶	りょくちゃ	Chè xanh, chè tươi	LỤC TRÀ
編み物	あみもの	đồ đan len	BIÊN VẬT
縮小	しゅくしょう	Cắt giảm, thu nhỏ, nén lại	SÚC TIỂU
習得	しゅうとく	Thu được, lĩnh hội	TẬP ĐẮC
老いる	おいる	Già, già lão	LÃO
老人	ろうじん	người già 	LÃO NHÂN
聞き取り	ききとり	nghe hiểu 	VĂN THỦ
能力	のうりょく	năng lực 	NĂNG LỰC
自信	じしん	tự tin	TỰ TÍN
自動券売機	じどうけんばいき	máy bán hàng tự động 	TỰ ĐỘNG KHÓAN MẠI CƠ
若い	わかい	trẻ; trẻ trung	NHƯỢC
表	おもて／ひょう	bề ngoài, mặt ngoài／biểu, bảng, phiếu	BIỂU
表す	あらわす	biểu thị, biểu hiện 	BIỂU
表示	ひょうじ	hiển thị 	BIỂU THỊ
見積もる	みつもる	Đánh giá, ước lượng	KIẾN TÍCH
設定	せってい	thiết lập, tạo ra 	THIẾT ĐỊNH
設計	せっけい	thiết kế 	THIẾT KẾ
認める	みとめる	thừa nhận, công nhận 	NHẬN
認め印	みとめいん	con dấu 	thay cho chữ ký	NHẬN ẤN
調べる	しらべる	điều tra, tra 	ĐiỀU, ĐiỆU
貨物	かもつ	Hàng hoá, hàng chuyên chở	HÓA VẬT
販売	はんばい	bán, việc bán 	PHÁN MẠI
返す	かえす	trả, trả lại 	PHẢN
返事	へんじ	hồi âm, trả lời 	PHẢN SỰ
返済	へんさい	Trả lại tiền	PHẢN TẾ
返金	へんきん	Hoàn trả tiền	PHẢN KIM
送信箱	そうしんばこ	hộp thư đi 	TỐNG TÍN SƯƠNG, TƯƠNG
運転切換	うんてんきりかえ	Chuyển đổi hoạt động	VẬN CHUYỂN THIẾT HÓAN
違い	ちがい	sai 	VI	VĨ
適合	てきごう	Thích hợp, thích nghi	THÍCH HỢP
選ぶ	えらぶ	chọn 	THIÊN	TUYỂN
選手	せんしゅ	tuyển thủ 	THIÊN	TUYỂN THỦ
選択	せんたく 	tuyển chọn, chọn lựa 	THIÊN	TUYỂN TRẠCH
選考	せんこう	Lựa chọn	THIÊN	TUYỂN KHẢO
量る	はかる	cân, đo 	LƯỢNG
録画	ろくが	ghi hình, ghi băng video	LỤC HỌA, HOẠCH
録音	ろくおん	ghi âm 	LỤC ÂM
間違い	まちがい	nhầm lẫn 	GIAN, GIÁN VI	VĨ
間違える	まちがえる	nhầm lẫn 	GIAN, GIÁN VI	VĨ
除く	のぞく	xoá	TRỪ
集団	しゅうだん	Nhóm, tập thể, đoàn thể	TẬP ĐÒAN
音声	おんせい	Giọng nói, thanh âm	ÂM THANH
音量	おんりょう	Âm lượng	ÂM LƯỢNG
預かる	あずかる	trông nom, chăm sóc 	DỰ
預ける	あずける	giao cho, giao phó, gửi 	DỰ
預金	よきん	gửi tiền 	DỰ KIM
風の向き	かぜのむき	Hướng gió	PHONG HƯỚNG
風量	ふうりょう	Khối lượng không khí	PHONG LƯỢNG
飛行機	ひこうき	máy bay 	KHIÊU	PHI HÀNH, HÀNG, HẠNH CƠ
上等	じょうとう	Tuyệt hảo, chất lượng tốt, thượng hạng	THƯỢNG ĐẲNG
事柄	ことがら	Sự việc, vấn đề	SỰ BÍNH
交渉	こうしょう	Thương thảo, đàm phán	GIAO THIỆP
任せる	まかせる	hết sức, dốc lòng	NHIỆM
作法	さほう	Cách cư xử	TÁC PHÁP
分担	ぶんたん	gánh vác 	trách nhiệm	PHÂN ĐẢM
刑事	けいじ	Hình sự	HÌNH SỰ
務める	つとめる	Làm việc; Giữ nhiệm vụ, làm công tác	VỤ
協会	きょうかい	tổ chức, hiệp hội 	HIỆP HỘI
去る	さる	Qua đi, rời đi	KHỬ, KHỨ
在中	ざいちゅう	có chứa 	giấy tờ, tài liệu... bên trong	TẠI TRUNG, TRÚNG
客席	きゃくせき	ghế khán giả, ghế ngồi xem	KHÁCH TỊCH
新装開店	しんそうかいてん	Mở cửa kinh doanh sau khi trang trí lại cửa tiệm	TÂN TRANG KHAI ĐiẾM
服装	ふくそう	Quần áo, trang phục	PHỤC TRANG
果実	かじつ	Quả	QUẢ THỰC
根拠	こんきょ	Cơ bản, nền tảng	CĂN CỨ
気配	けはい	cảm giác, linh cảm, dấu hiệu	KHÍ PHỐI
異変	いへん	Tai nạn, sự khác thường	DỊ BiẾN
移転	いてん	di chuyển; chuyển giao	DI CHUYỂN
落ち葉	おちば	Lá rơi, lá rụng	LẠC DIỆP
衣服	いふく	y phục, trang phục 	Y PHỤC
負う	おう	Đảm đương, gánh vác	PHỤ
負担	ふたん	gánh vác 	PHỤ ĐẢM
貯蔵	ちょぞう	tàng trữ, dự trữ, chứa	TRỮ TÀNG
込める	こめる	Tống vào, nạp vào	VÀO
領	りょう	Lãnh thổ	LĨNH, LÃNH
領収書	りょうしゅうしょ	biên lai	LĨNH, LÃNH THU THƯ
包装	ほうそう	Đóng gói, gói lại	BAO TRANG
外相	がいしょう	Bộ trưởng ngoại giao	NGOẠI TƯƠNG, TƯỚNG
相当	そうとう	Đáng kể, kha khá	TƯƠNG, TƯỚNG ĐANG, ĐƯƠNG
～し難い	～しがたい	khó ～	NẠN
～と共に	～とともに	cùng với ~ 	CỘNG
～位	～い	vị trí	VỊ
～個	～こ	cái ~ 	đếm vật hình khối	CÁ
～各位	～かくい	các vị; các ngài; kính gửi các quý vị; gửi toàn thể	CÁC VỊ
～様	～さま	ngài 	DẠNG
～殿	～どの	Bà, ngài	ĐiỆN
～相当	～そうとう	tương đương 	TƯƠNG, TƯỚNG ĐANG, ĐƯƠNG
～等	～など	~ vân vân 	ĐẲNG
～製	～せい	hàng ~ 	CHẾ
～軒	～けん	～căn, nhà 	đếm tòa nhà	hiên
～限り	～かぎり	theo như ~	HẠN
～領	～りょう	quản trị 	LĨNH, LÃNH
お参り	おまいり	sự lễ chùa 	TAM, THAM
お客様	おきゃくさま	quý khách	KHÁCH DẠNG
お越しの際（＝来たとき）	おこしのさい（＝きたとき）	khi đến 	VIỆT TẾ LAI
ゴミ集積所	ゴミしゅうせきじょ	Điểm thu gom rác	TẬP TÍCH SỞ
その他	そのた	cái khác, ngoài ra	THA
レジ袋	レジぶくろ 	túi nhựa 	nhận tại quầy tính tiền	ĐẠI
下記	かき	Như sau, như bên dưới	HẠ KÝ
不在	ふざい	Vắng mặt	BẤT TẠI
不燃	ふねん	Không cháy, không bắt lửa	BẤT NHIÊN
中毒	"ちゅうどく	1. trúng độc 2. ghiền, nghiện	TRUNG, TRÚNG ĐỘC"
主役	しゅやく	Chỉ huy, đứng đầu	CHỦ DỊCH
乗り越す	のりこす	vượt qua 	THỪA, THẶNG VIỆT
乗客	じょうきゃく	hành khách 	THỪA, THẶNG KHÁCH
事務	じむ	công việc 	SỰ VỤ
事務所	じむしょ	nơi làm việc, văn phòng 	SỰ VỤ SỞ
交換	こうかん	trao đổi 	GIAO HÓAN
交流	こうりゅう	giao lưu 	GIAO LƯU
交通機関	こうつうきかん	cơ quan giao thông 	GIAO THÔNG CƠ QUAN
交際	こうさい	mối quan hệ, giao du	GIAO TẾ
他人	たにん	người khác 	THA NHÂN
他方	たほう	hướng khác, phương khác 	THA PHƯƠNG
任務	にんむ	Nhiệm vụ, công việc	NHIỆM VỤ
伝染病	でんせんびょう	Bệnh truyền nhiễm	TRUYỀN, TRUYỆN NHIỄM BỆNH
位	い	Hạng, thứ, vị trí	VỊ
住居	じゅうきょ	Nơi cư trú	TRÚ CƯ
便利（な）	べんり（な）	tiện lợi, thuận tiện 	TIỆN LỢI
保管	ほかん	Bảo quản, canh giữ, trông coi	BẢO QUẢN
個々	ここ	từng cái, từng 	CÁ
個人	こじん	cá nhân 	CÁ NHÂN
個別	こべつ	cá biệt 	CÁ BIỆT
入荷	にゅうか	nhận hàng, nhập hàng 	NHẬP HÀ
全～	ぜん～	toàn ~ 	TÒAN
全く	まったく	tất cả 	TÒAN
全て	すべて	tất cả 	TÒAN
全国	ぜんこく	toàn quốc 	TÒAN QUỐC
共通	きょうつう	cộng đồng 	CỘNG THÔNG
内容	ないよう	nội dung 	NỘI DUNG
内臓	ないぞう	Nội tạng	NỘI TẠNG
円周	えんしゅう	Chu vi	VIÊN CHU
冷凍	れいとう	làm lạnh, làm đông lạnh 	LÃNH ĐỐNG
冷蔵	れいぞう	làm lạnh 	LÃNH TÀNG
凍える	こごえる	bị đóng băng 	ĐỐNG
凍る	こおる	đóng băng 	ĐỐNG
出荷	しゅっか	đưa hàng, giao hàng 	XUẤT HÀ
利用	りよう	sử dụng 	LỢI DỤNG
加える	くわえる	gia tăng, thêm vào 	GIA
加わる	くわわる	tham gia, gia nhập 	GIA
加速	かそく	gia tốc, làm nhanh thêm 	GIA TỐC
効き目	ききめ	Công dụng, tác dụng	HIỆU MỤC
効く	きく	có hiệu quả, có kết quả	HIỆU
効果	こうか	hiệu quả 	HIỆU QUẢ
協力	きょうりょく	hợp tác, hiệp lực 	HIỆP LỰC
協定	きょうてい	Hiệp định, hiệp ước	HIỆP ĐỊNH
参る	まいる	đi 	TAM, THAM
参加	さんか	tham gia 	TAM, THAM GIA
参考書	さんこうしょ	sách tham khảo 	TAM, THAM KHẢO THƯ
収める	おさめる	thu được, giao nộp	THU
収入	しゅうにゅう	thu nhập 	THU NHẬP
収集	しゅうしゅう	Thu thập, thu gom	THU TẬP
受話器	じゅわき	Ống nghe điện thoại	THỤ THOẠI KHÍ
可燃	かねん	Cháy	KHẢ NHIÊN
各～	かく～	mỗi, các ~ 	CÁC
各位	かくい	Kính gởi các quí vị, gởi toàn thể	CÁC VỊ
各地	かくち	các đại phương, các nơi 	CÁC ĐỊA
各自	かくじ	mỗi cá nhân 	CÁC TỰ
同封	どうふう	gửi kèm theo	ĐỒNG PHONG
同案異義語	どうあんいぎご	đồng từ khác nghĩa 	ĐỒNG ÁN DỊ NGHĨA NGỮ
同様	どうよう	đồng dạng, như 	ĐỒNG DẠNG
同音異義語	どうおんいぎご	Chữ đồng âm dị nghĩa	ĐỒNG ÂM DỊ NGHĨA NGỮ
吸収	きゅうしゅう	Tiếp thu, tiếp quản	HẤP THU
周り	まわり	xung quanh	CHU
商品	しょうひん	hàng hóa, sản phẩm 	THƯƠNG PHẨM
商売	しょうばい	Kinh doanh	THƯƠNG MẠI
商店	しょうてん	cửa hiệu, cửa hàng buôn bán 	THƯƠNG ĐiẾM
商業	しょうぎょう	buôn bán, thương mại 	THƯƠNG NGHIỆP
器	うつわ	Đồ dùng, dụng cụ	KHÍ
器械体操	きかいたいそう	máy tập thể dục 	KHÍ GIỚI THỂ THÁO, THAO
回収	かいしゅう	thu hồi, thu lại 	HỒI THU
困難（な）	こんなん（な）	khó khăn, vất vả 	KHỐN NẠN
在学	ざいがく	Theo học, đang học	TẠI HỌC
地位	ちい	vị trí, địa vị 	ĐỊA VỊ
地震	じしん	động đất 	ĐỊA CHẤN
埋まる	うまる	bị lấp đầy 	MAI
埋める	うめる	chon, chôn cất 	MAI
埋め立てる	うめたてる	lấp đất	MAI LẬP
変更	へんこう	biến đổi 	BiẾN CANH
大統領	だいとうりょう	tổng thống 	ĐẠI THỐNG LĨNH, LÃNH
完全（な）	かんぜん（な）	toàn bộ, hoàn toàn 	HÒAN TÒAN
容器	ようき	Đồ đựng	DUNG KHÍ
封書	ふうしょ	Thư đã cho vào dán kín	PHONG THƯ
小枝	こえだ	cành cây nhỏ 	TIỂU CHI
届く	とどく	đến, tới 	GIỚI
届ける	とどける	đưa đến, đưa tới 	GIỚI
届け出	とどけで	thông báo, báo cáo	GIỚI XUẤT
平ら	たいら	Bằng phẳng, phẳng	BÌNH
平仮名	ひらがな	chữ hiragana	BÌNH GIẢ DANH
平成	へいせい	thời đại Bình Thành	BÌNH THÀNH
平日	へいじつ	ngày thường 	BÌNH NHẬT
平気（な）	へいき（な）	bình tĩnh 	BÌNH KHÍ
平等	びょうどう	Bình đẳng, không thiên vị	BÌNH ĐẲNG
延ばす	のばす	làm giãn ra	DIÊN
延びる	のびる	kéo dài, giãn ra 	DIÊN
延期	えんき	Hoãn lại	DIÊN KỲ
延長	えんちょう	kéo dài 	DIÊN TRƯỜNG, TRƯỞNG
弁当	べんとう	cơm hộp 	BIỆN ĐANG, ĐƯƠNG
引っ越す	ひっこす	dọn nhà 	DẪN VIỆT
当～	とう～	～ này 	ĐANG, ĐƯƠNG
当たる	あたる	đúng 	trả lời, trúng 	đạn	ĐANG, ĐƯƠNG
当日	とうじつ	ngày hôm đó 	ĐANG, ĐƯƠNG NHẬT
心細い	こころぼそい	Đơn độc, cô đơn, buồn bã	TĂM TẾ
心配（な）	しんぱい（な）	lo lắng 	TĂM PHỐI
必ず	かならず	nhất định 	TẤT
必死	ひっし	quyết tâm 	TẤT TỬ
必要（な）	ひつよう（な）	cần thiết, tất yếu 	TẤT YÊU, YẾU
忘れる	わすれる	quên, bỏ quên 	VONG
忘れ物	わすれもの	đồ bỏ quên, vật bỏ quên 	VONG VẬT
忘年会	ぼうねんかい	tiệc cuối năm 	VONG NIÊN HỘI
思い込む	おもいこむ	Tin, nghĩ rằng	TƯ VÀO
手袋	てぶくろ 	bao tay, găng tay 	THỦ ĐẠI
払い込む	はらいこむ	Giao nộp, giao tiền	PHẤT VÀO
折り曲げる	おりまげる	Gấp	CHIẾT, TRIẾT KHÚC
担任	たんにん	Giáo viên chủ nhiệm	ĐẢM NHIỆM
担当	たんとう	đảm đương, trách nhiệm 	ĐẢM ĐANG, ĐƯƠNG
持参	じさん	Đem theo, mang theo	TRÌ TAM, THAM
教訓	きょうくん	Bài học	GIÁO HUẤN
文法	ぶんぽう	ngữ pháp 	VĂN PHÁP
断る	ことわる	từ chối, bác bỏ 	ĐÓAN
断定	だんてい	kết luận 	ĐÓAN ĐỊNH
断水	だんすい	cắt nước 	ĐÓAN THỦY
方法	ほうほう	phương pháp 	PHƯƠNG PHÁP
日記	にっき	nhật ký 	NHẬT KÝ
日誌	にっし	Sổ nhật ký, sổ ghi nhớ	NHẬT CHÍ
明細	めいさい	Chi tiết, rõ ràng	MINH TẾ
昨～	さく～	～ trước	TẠC
曲	きょく	khúc 	nhạc 	KHÚC
曲がる	まがる	rẽ, uống cong	KHÚC
曲線	きょくせん	Đường cong, đường vòng	KHÚC TUYẾN
更新	こうしん	Cập nhật, đổi mới	CANH TÂN
更衣室	こういしつ	Phòng thay quần áo	CANH Y THẤT
有利（な）	ゆうり（な）	có ích, có lợi 	HỮU LỢI
有効	ゆうこう	có hiệu quả, hữu hiệu	HỮU HIỆU
期限	きげん	thời hạn, kỳ hạn 	KỲ HẠN
果たす	はたす	Hoàn thành	QUẢ
果物	くだもの	trái cây	QUẢ VẬT
枝	えだ	cành cây 	CHI
植物	しょくぶつ	Thực vật, cây cối	THỰC VẬT
楽器	がっき	Nhạc cụ	NHẠC, LẠC KHÍ
様々（な）	さまざま（な）	đa dạng, nhiều loại 	DẠNG
様子	ようす	tình trạng 	DẠNG TỬ, TÝ
横断	おうだん	băng qua	HOẠNH, HOÀNH ĐÓAN
機械	きかい	cơ khí, máy móc 	CƠ GIỚI
殿様	とのさま	vua chúa 	ĐiỆN DẠNG
気の毒	きのどく	Đáng thương, đáng thương hại	KHÍ ĐỘC
水道管	すいどうかん	Ống nước	THỦY ĐẠO QUẢN
汚い	きたない	dơ, bẩn thỉu 	Ô
汚す	よごす	làm bẩn 	Ô
汚れる	よごれる	bị bẩn, dơ 	Ô
汚染	おせん	ô nhiễm 	Ô NHIỄM
法人	ほうじん	Pháp nhân	PHÁP NHÂN
消毒	しょうどく	tiêu độc; khử trùng	TIÊU ĐỘC
涙	なみだ	nước mắt	LỤY, LỆ
燃やせる	もやせる	Cháy	NHIÊN
燃料	ねんりょう	Nhiên liệu, chất đốt	NHIÊN LIỆU
現在	げんざい	hiện tại 	HIỆN TẠI
現象	げんしょう	Hiện tượng	HIỆN TƯỢNG
申し込む	"もうしこむ	1. đàm phán, thương lượng 2. đặt hàng 3. cầu hôn	THÂN VÀO"
畑	はたけ	ruộng, ruộng nương 	VƯỜN
異なる	ことなる	khác, khác với 	DỊ
異常（な）	いじょう（な）	không bình thường	DỊ THƯỜNG
相変わらず	あいかわらず	Vẫn, như mọi khi	TƯƠNG, TƯỚNG BiẾN
相手	あいて	đối phương, đối thủ 	TƯƠNG, TƯỚNG THỦ
相撲	すもう	sumo	TƯƠNG, TƯỚNG BỘC, PHỐC
移す	うつす	dọn đi, chuyển đi 	DI
移る	うつる	di chuyển 	DI
移動	いどう	di chuyển 	DI ĐỘNG
積む	つむ	chất, xếp 	TÍCH
積もる	つもる	được chất đống 	TÍCH
笑う	わらう	cười	TiẾU
笑む	えむ	mỉm cười	TiẾU
等	など	vân vân	ĐẲNG
等しい	ひとしい	Bằng, ngang nhau	ĐẲNG
管	かん	Ống, ống dẫn	QUẢN
管理	かんり	quản lý 	QUẢN LÝ
紅葉	こうよう	lá đỏ 	HỒNG DIỆP
細い	ほそい	gầy, ốm 	TẾ
細かい	こまかい	chi tiết, tỉ mỉ 	TẾ
経済	けいざい	kinh tế 	KINH TẾ
経理	けいり	kế toán 	KINH LÝ
経過	けいか	tiến trình, sự trải qua	KINH OA	QUÁ
経験	けいけん	kinh nghiệm 	KINH NGHIỆM
結ぶ	むすぶ	buộc, nối 	KẾT
結局	けっきょく	kết cục 	KẾT CỤC
結果	けっか	kết quả 	KẾT QUẢ
練習	れんしゅう	luyện tập 	LUYỆN TẬP
美容	びよう	vẻ đẹp, dung nhan	MỸ DUNG
翌～	よく～	～ sau	DỰC
翌日	よくじつ	Ngày hôm sau	DỰC NHẬT
翌朝	よくあさ	sáng hôm sau	DỰC TRIỀU
花畑	はなばたけ 	Vườn hoa	HOA VƯỜN
荷物	にもつ	hành lý 	HÀ VẬT
葉	は	lá 	DIỆP
衣料品	いりょうひん	Hàng may mặc	Y LIỆU PHẨM
衣装	いしょう	Quần áo, y phục	Y TRANG
衣類	いるい	quần áo 	Y LOẠI
衣食住	いしょくじゅう	Miếng cơm manh áo và chỗ nương thân	Y THỰC TRÚ
袋	ふくろ	bao, túi 	ĐẠI
製品	せいひん	hàng hóa, sản phẩm 	CHẾ PHẨM
要る	いる	cần	YÊU, YẾU
要点	ようてん	Ý chính	YÊU, YẾU ĐiỂM
要約	ようやく	Tóm tắt, tóm lược	YÊU, YẾU ƯỚC
言葉	ことば	từ vựng 	NGÔN DIỆP
訓練	くんれん	Tập huấn, huấn luyện	HUẤN LUYỆN
訓読み	くんよみ	cách đọc âm hán trong tiếng nhật 	HUẤN ĐỘC
記す	しるす	Ghi chép lại	KÝ
記事	きじ	Tin tức, bài báo	KÝ SỰ
記入	きにゅう	ghi vào, điền vào 	KÝ NHẬP
記号	きごう	ký hiệu 	KÝ HIỆU
記者	きしゃ	Kí giả, phóng viên	KÝ GIẢ
負ける	まける	thua 	PHỤ
責める	せめる	Buộc tội, kết tội	TRÁCH
責任	せきにん	trách nhiệm 	TRÁCH NHIỆM
資料	しりょう 	tài liệu 	TƯ LIỆU
資源	しげん	tài nguyên 	TƯ NGUYÊN
資金	しきん	Quỹ, tiền, vốn	TƯ KIM
足袋	たび	tất có ngón của nhật 	TÚC ĐẠI
込む	こむ	đông đúc 	VÀO
近郊	きんこう	Ngoại ô 	phạm vi rộng hơn 郊外）	CÂ?N GIAO
迷う	まよう	lạc đường 	MÊ
迷信	めいしん	Mê tín, dị đoan	MÊ TÍN
迷子	まいご	trẻ lạc 	MÊ TỬ, TÝ
迷惑	めいわく	phiền hà, quấy rầy 	MÊ HOẶC
通過	つうか	đi qua, vượt qua	THÔNG OA	QUÁ
連れる	つれる	dẫn theo, dắt 	LIÊN
連休	れんきゅう	kỳ nghỉ, đợt nghỉ 	LIÊN HƯU
連絡	れんらく	liên lạc	LIÊN LẠC
連続	れんぞく	Tiếp tục, liên tục	LIÊN TỤC
過ぎる	すぎる	quá, vượt quá 	OA	QUÁ
過ごす	すごす	trải qua 	OA	QUÁ
過去	かこ	quá khứ 	OA	QUÁ KHỬ, KHỨ
避難	ひなん	lánh nạn, tị nạn 	TỴ NẠN
郊外	こうがい	Ngoại ô	GIAO NGOẠI
配る	くばる	phân phát, phân phối 	PHỐI
配達	はいたつ	phân phát, đưa cho 	PHỐI ĐẠT
重要（な）	じゅうよう（な）	quan trọng, trọng yếu 	TRỌNG, TRÙNG YÊU, YẾU
金利	きんり	Lãi suất, tiền lãi	KIM LỢI
金額	きんがく	kim ngạch 	KIM NGẠCH
開封	かいふう	Mở thư	KHAI PHONG
関連	かんれん	Mối quan hệ, liên quan	QUAN LIÊN
限度額	げんどがく	Hạn mức tín dụng	HẠN ĐỘ NGẠCH
限界	げんかい	giới hạn 	HẠN GIỚI
雑な	ざつな	Linh tinh; tạp nham	TẠP
雑用	ざつよう	Việc lặt vặt	TẠP DỤNG
雑誌	ざっし	tạp chí 	TẠP CHÍ
雑貨	ざっか	Đồ lặt vặt	TẠP HÓA
雑音	ざつおん	tạp âm 	TẠP ÂM
難しい	むずかしい	khó 	bài tập 	NẠN
震える	ふるえる	Rung, lay động	CHẤN
面積	めんせき	diện tích 	DIỆN TÍCH
頂く	いただく	xin nhận 	ĐỈNH
頂上	ちょうじょう	đỉnh núi, đỉnh 	ĐỈNH THƯỢNG
頂点	ちょうてん	Đỉnh cao, đỉnh điểm	ĐỈNH ĐiỂM
領事館	りょうじかん	lãnh sự quán	LĨNH, LÃNH SỰ QUÁN
額	ひたい	trán 	NGẠCH
額	がく	kim ngạch; khoản tiền; số tiền; mức tiền	NGẠCH
願う	ねがう	cầu mong, cầu xin	NGUYỆN
願書	がんしょ	đơn xin nhập học 	NGUYỆN THƯ
飛び込む	とびこむ	nhảy vào, lao vào 	KHIÊU	PHI VÀO
食器	しょっき	dụng cụ ăn 	 chén, bát 	THỰC KHÍ
首相	しゅしょう	thủ tướng 	THỦ TƯƠNG, TƯỚNG
高等学校	こうとうがっこう	trường cao đẳng	CAO ĐẲNG HỌC HIỆU
駐車	ちゅうしゃ sự đậu xe,đỗ xe TRÚ XA
駐車場	ちゅうしゃじょう Bãi đậu xe TRÚ XA TRƯỜNG, TRÀNG
無休	むきゅう Không có ngày nghỉ VÔ HƯU
無料	むりょう Miễn phí VÔ LIỆU
無理	むり Điều vô lý, quá sức VÔ LÝ
無い	ない Không có,không,không tồn tại VÔ
満車	まんしゃ Sự xếp đầy, sự chở đầy,sự tải đầy MÃN XA
満員	まんいん Sự đông người; sự chật ních người MÃN VIÊN
不満	ふまん Bất mãn BẤT MÃN
向こう	むこう Mặt khác,đối diện,phần kia HƯỚNG
向かう	むかう Hướng về, đối diện,quay về phía HƯỚNG
向き	むき Phù hợp với HƯỚNG
方向	ほうこう Hướng,lối đi,mục tiêu,mục đích PHƯƠNG HƯỚNG
禁止	きんし Cấm CẤM CHỈ
関心	かんしん Mối quan tâm,môi lưu tâm QUAN TĂM
（に）関する	かんする Liên quan đến,liên quan với QUAN
関係	かんけい Liên quan QUAN HỆ
係	かかり Nhiệm vụ,bổn phận,phụ trách HỆ
無断	むだん Không xin phép VÔ ĐÓAN
断る	ことわる Từ chối ĐÓAN
許可	きょか Sự cho phép,đồng ý,chấp thuận HỨA KHẢ
係の人	かかりのひと Người phụ trách HỆ NHÂN
空車	くうしゃ Xe trống KHÔNG XA
横断	おうだん Chỗ băng qua,chỗ giao nhau HOẠNH, HOÀNH ĐÓAN
横断歩道	おうだんほどう Đường dành cho người đi bộ HOẠNH, HOÀNH ĐÓAN BỘ ĐẠO
横	よこ Bề ngang,chiều ngang,cạnh,bên cạnh HOẠNH, HOÀNH
押す	おす Nhấn 	nút,công tắc... ÁP
押さえる	おさえる Giữ chặt,bắt,bắt giữ ÁP
押入れ	おしいれ Tủ âm tường ÁP NHẬP
入学式	にゅうがくしき Lễ nhập học NHẬP HỌC THỨC
数式	すうしき Dạng số SỐ THỨC
送信	そうしん Sự truyền đi,sự phát đi TỐNG TÍN
信じる	しんじる Tin tưởng TÍN
自信	じしん Tự tin TỰ TÍN
信用	しんよう Tin tưởng, tin cậy, tín nhiệm TÍN DỤNG
信号	しんごう Đèn giao thông TÍN HIỆU
～号車	～ごうしゃ Chuyến xe số ～ HIỆU XA
正確	せいかく Chính xác,đúng,đúng đắn CHÍNH XÁC
確か	たしか Chắc,chắc chắn XÁC
確かめる	たしかめる Xác nhận,kiểm tra XÁC
確認	かくにん Xác nhận,xác minh XÁC NHẬN
認める	みとめる Công nhận,thừa nhận,cho phép NHẬN
飛行場	ひこうじょう Sân bay KHIÊU	PHI HÀNH, HÀNG, HẠNH TRƯỜNG, TRÀNG
飛ぶ	とぶ Bay KHIÊU	PHI
左右	さゆう Trái phải, ảnh hưởng, chi phối. TẢ HỮU
非常	ひじょう Khẩn cấp, cấp bách PHI THƯỜNG
非常に	ひじょうに Rất,cực kì PHI THƯỜNG
非常口	ひじょうぐち Cửa thoát hiểm PHI THƯỜNG KHẨU
日常	にちじょう Thường ngày NHẬT THƯỜNG
～階	～かい Tầng GIAI
階段	かいだん Cầu thang GIAI ĐỌAN
箱	はこ Cái hộp, thùng SƯƠNG, TƯƠNG
ごみ箱	ごみばこ Thùng rác SƯƠNG, TƯƠNG
危険	きけん Nguy hiểm,mạo hiểm NGUY HiỂM
危ない	あぶない Nguy hiểm NGUY
捨てる	すてる Ném XẢ
線	せん Tuyến TUYẾN
～番線	～ばんせん Tuyến số ～ PHIÊN TUYẾN
全面	ぜんめん Toàn bộ,tất cả TÒAN DIỆN
画面	がめん Màn hình HỌA, HOẠCH DIỆN
方面	ほうめん Vùng, khu vực, phương diện PHƯƠNG DIỆN
普通	ふつう Bình thường, thông thường PHỔ THÔNG
各駅	かくえき mỗi trạm, các trạm CÁC DỊCH
各国	かっこく Mỗi nước CÁC QUỐC
各自	かくじ Mỗi cá nhân CÁC TỰ
目次	もくじ Bảng mục lục MỤC THỨ
次	つぎ Kế tiếp, tiếp theo THỨ
次回	じかい Lần tới THỨ HỒI
快速	かいそく Nhanh chóng,cực nhanh,siêu tốc KHÓAI TỐC
高速道路	こうそくどうろ Đường cao tốc CAO TỐC ĐẠO LỘ
速度	そくど Tốc độ TỐC ĐỘ
速い	はやい Nhanh TỐC
過去	かこ Quá khứ OA	QUÁ KHỬ, KHỨ
過ぎる	すぎる Vượt quá OA	QUÁ
地下鉄	ちかてつ Tàu điện ngầm ĐỊA HẠ THIẾT
鉄	てつ Thiết THIẾT
鉄道	てつどう Đường sắt THIẾT ĐẠO
先発	せんぱつ Sự đi đầu,sự bắt đầu TIÊN PHÁT
指定	してい Sự chỉ định,chọn lựa,bổ nhiệm CHỈ	SÁP, THÁP ĐỊNH
指	ゆび Ngón tay CHỈ	SÁP, THÁP
指定席	していせき Chỗ ngồi đã định sẵn CHỈ	SÁP, THÁP ĐỊNH TỊCH
指輪	ゆびわ Nhẫn CHỈ	SÁP, THÁP LUÂN
定休日	ていきゅうび Ngày nghỉ thường kì ĐỊNH HƯU NHẬT
安定	あんてい Ổn định,ổn thoả,yên ổn AN, YÊN ĐỊNH
不安定	ふあんてい Không yên ổn BẤT AN, YÊN ĐỊNH
席	せき Chỗ ngồi TỊCH
出席	しゅっせき Tham dự,có mặt XUẤT TỊCH
欠席	けっせき Vắng mặt KHUYẾT TỊCH
自由	じゆう Tự do TỰ DO
自由席	じゆうせき Chỗ ngồi tự do TỰ DO TỊCH
理由	りゆう Lý do LÝ DO
番号	ばんごう Số PHIÊN HIỆU
窓	まど Cửa sổ SONG
窓口	まどぐち Cửa bán vé SONG KHẨU
両側	りょうがわ Cả 2 hướng LƯỠNG TRẮC
窓側	まどがわ Phía cửa sổ SONG TRẮC
右側	みぎがわ Phía bên phải HỮU TRẮC
道路	どうろ Đường phố,con đường ĐẠO LỘ
線路	せんろ Đường ray TUYẾN LỘ
停車	ていしゃ Dừng 	xe,tàu ĐÌNH XA
バス停	バスてい Trạm xe buýt ĐÌNH
整理	せいり Điều chỉnh, sắp xếp CHỈNH LÝ
駐車券	ちゅうしゃけん Vé đậu xe TRÚ XA KHÓAN
乗車券	じょうしゃけん Vé xe, vé tàu THỪA, THẶNG XA KHÓAN
現金	げんきん Tiền mặt HIỆN KIM
表現	ひょうげん Thể hiện,diễn tả,diễn đạt BIỂU HIỆN
現れる	あらわれる Xuất hiện HIỆN
両親	りょうしん Bố mẹ LƯỠNG THÂN
～両	～りょう Cả hai LƯỠNG
取り替える	とりかえる Đổi,thay thế,thay mới THỦ THẾ
着替える	きがえる Thay quần áo TRƯỚC THẾ
両替	りょうがえ Đổi tiền LƯỠNG THẾ
優先席	ゆうせんせき Chỗ ngồi ưu tiên ƯU TIÊN TỊCH
女優	じょゆう Diễn viên nữ NỮ ƯU
優しい	やさしい Hiền dịu,dịu dàng,tử tế ƯU
正座	せいざ Ngồi đúng tư thế CHÍNH TỌA
座席	ざせき Chỗ ngồi TỌA TỊCH
座る	すわる Ngồi TỌA
降車口	こうしゃぐち Lối xuống xe GIÁNG, HÀNG XA KHẨU
以降～	いこう～ Sau ～ DĨ GIÁNG, HÀNG
降りる	おりる Xuống 	xe,tàu... GIÁNG, HÀNG
降る	ふる Rơi 	tuyết,mưa GIÁNG, HÀNG
未定	みてい Chưa xác định VỊ, MÙI ĐỊNH
未来	みらい Tương lai VỊ, MÙI
未満	みまん Ít hơn VỊ, MÙI MÃN
週末	しゅうまつ Cuối tuần CHU MẠT
年末	ねんまつ Cuối năm NIÊN MẠT
月末	げつまつ Cuối tháng NGUYỆT MẠT
若い	わかい Trẻ NHƯỢC
晩	ばん Tối VÃN
晩御飯	ばんごはん Cơm tối VÃN NGỰ, NGỪ PHẠN
今晩	こんばん Tối nay KIM VÃN
毎晩	まいばん Mỗi tối MỖI VÃN
島	しま Đảo ĐẢO
～島	～とう Đảo ～ ĐẢO
皿	さら Dĩa MÀNH
灰皿	はいざら Gạt tàn thuốc KHÔI MÀNH
出血	しゅっけつ Sự chảy máu,sự xuất huyết XUẤT HUYẾT
血	ち Máu HUYẾT
助ける	たすける Cứu,cứu giúp TRỢ
断水	だんすい Cắt nước ĐÓAN THỦY
押しボタン式	おしボタンしき Dạng nút bấm ÁP THỨC
正常	せいじょう Bình thường 	không có gì khác thường CHÍNH THƯỜNG
通過	つうか Đi qua,thông qua THÔNG OA	QUÁ
通路	つうろ Hành lang,lối đi THÔNG LỘ
整理券	せいりけん Vé theo số CHỈNH LÝ KHÓAN
回数券	かいすうけん Cuốn vé,tập vé HỒI SỐ KHÓAN
以降	いこう Sau... DĨ GIÁNG, HÀNG
救助	きゅうじょ Cứu CỨU TRỢ
準備	じゅんび Chuẩn bị,thu xếp CHUẨN BỊ
備える	そなえる Chuẩn bị,dự phòng, trang bị	đồ đạc BỊ
営業	えいぎょう Thương mại,doanh nghiệp,buôn bán DOANH, DINH NGHIỆP
開閉	かいへい Sự đóng và mở,đóng mở KHAI BẾ
（が）閉まる	しまる Đóng,bị đóng BẾ
（を）閉める	しめる Đóng BẾ
案内	あんない Hướng dẫn ÁN NỘI
案	あん Đề án,dự án ÁN
家内	かない Vợ mình GIA NỘI
以内	いない Trong vòng DĨ NỘI
国内	こくない Trong nước QUỐC NỘI
内側	うちがわ Phía bên trong NỘI TRẮC
予定	よてい Dự định,chương trình,kế hoạch DƯ ĐỊNH
予習	よしゅう Chuẩn bị bài trước DƯ TẬP
予約	よやく Đặt chỗ,đăng kí trước DƯ ƯỚC
約～	やく～ Khoảng ～ ƯỚC
承る	うけたまわる Chấp nhận,tiếp nhận,nghe THỪA
禁煙	きんえん Cấm hút thuốc CẤM YÊN
煙	けむり Khói YÊN
本当	ほんとう Sự thật,thực tế BẢN ĐANG, ĐƯƠNG
当～	とう～ ～này ĐANG, ĐƯƠNG
当たる	あたる Trúng,đúng,thắng ĐANG, ĐƯƠNG
全部	ぜんぶ Toàn bộ,tất cả TÒAN BỘ
全席	ぜんせき Toàn bộ chỗ ngồi TÒAN TỊCH
安全	あんぜん An toàn AN, YÊN TÒAN
客	きゃく Khách hàng KHÁCH
お客様	おきゃくさま Khách hàng KHÁCH DẠNG
様子	ようす Tình trạng,trạng thái,vẻ bề ngoài DẠNG TỬ, TÝ
理解	りかい Hiểu rõ,hiểu biết,nhận thức sâu sắc LÝ GIẢI
解答	かいとう Trả lời,giải ra GIẢI ĐÁP
解説	かいせつ Giải thích GIẢI THUYẾT
協力	きょうりょく Hợp tác,cộng tác HIỆP LỰC
願う	ねがう Mong muốn,ước muốn,yêu cầu,đề nghị NGUYỆN
宝くじ	たからくじ Vé số BẢO
お願い	おねがい Thỉnh cầu,yêu cầu NGUYỆN
観光	かんこう Đi tham quan,đi du lịch QUAN QUANG
観客	かんきゃく Khách tham quan QUAN KHÁCH
動物園	どうぶつえん Sở thú ĐỘNG VẬT VIÊN
空港	くうこう Sân bay KHÔNG CẢNG
港	みなと Bến cảng CẢNG
～港	～こう Cảng ～ CẢNG
遊園地	ゆうえんち Khu vui chơi DU VIÊN ĐỊA
遊ぶ	あそぶ Vui chơi,giải trí DU
美術館	びじゅつかん Viện bảo tàng mỹ thuật MỸ THUẬT QUÁN
美人	びじん Người đẹp MỸ NHÂN
美しい	うつくしい Xinh đẹp,xinh xắn,đẹp đẽ MỸ
美術	びじゅつ Mỹ thuật,nghệ thuật MỸ THUẬT
技術	ぎじゅつ Kĩ thuật KỸ THUẬT
手術	しゅじゅつ Phẫu thuật THỦ THUẬT
神社	じんじゃ Đền thần THẦN XÃ
神様	かみさま Thần thánh THẦN DẠNG
お寺	おてら Chùa TỰ
～寺	～じ Chùa ～ TỰ
気にする	きにする Quan tâm để ý KHÍ
市役所	しやくしょ Uỷ bản nhân dân thành phố THỊ DỊCH SỞ
役に立つ	やくにたつ Có tác dụng,hữu ích DỊCH LẬP
役員	やくいん Uỷ viên ban chấp hành,uỷ viên ban quản trị DỊCH VIÊN
郵便	ゆうびん Dịch vụ bưu điện BƯU TIỆN
郵便局	ゆうびんきょく Bưu điện BƯU TIỆN CỤC
薬局	やっきょく Tiệm thuốc DƯỢC CỤC
交番	こうばん Đồn cảnh sát GIAO PHIÊN
交通	こうつう Giao thông GIAO THÔNG
交換	こうかん Trao đổi,đánh đổi,đổi chác GIAO HÓAN
差出人	さしだしにん Người gởi SAI XUẤT NHÂN
交差点	こうさてん Ngã tư,chỗ giao nhau giữa 2 con đường GIAO SAI ĐiỂM
点数	てんすう Điểm số ĐiỂM SỐ
歩道橋	ほどうきょう Cầu vượt BỘ ĐẠO KIỀU
橋	はし Cầu KIỀU
公園	こうえん Công viên CÔNG VIÊN
受け取る	うけとる Nhận THỤ THỦ
受信	じゅしん Nhận tin THỤ TÍN
受ける	うける Nhận,dự	thi... THỤ
付ける	つける Gắn vào,dán,viết	nhật kí,ghi chú... PHÓ
片付ける	かたづける Dọn dẹp PHIẾN PHÓ
受付	うけつけ Quầy lễ tân THỤ PHÓ
付く	つく Gắn,dính,dán PHÓ
科学	かがく Khoa học KHOA HỌC
外科	げか Khoa ngoại NGOẠI KHOA
内科	ないか Khoa nội NỘI KHOA
教科書	きょうかしょ Sách giáo khoa GIÁO KHOA THƯ
耳鼻科	じびか Khoa tai mũi NHĨ TỴ KHOA
鼻	はな Mũi TỴ
婦人	ふじん Phụ nữ PHỤ NHÂN
主婦	しゅふ Nội trợ CHỦ PHỤ
形式	けいしき Hình thức HÌNH THỨC
整形外科	せいけいげか Khoa chỉnh hình CHỈNH HÌNH NGOẠI KHOA
形	かたち Hình dạng HÌNH
人形	にんぎょう Búp bê NHÂN HÌNH
骨折	こっせつ Gãy xương CỐT CHIẾT, TRIẾT
骨	ほね Xương CỐT
折る	おる Làm gãy,bẻ gãy,gấp lại,xếp lại CHIẾT, TRIẾT
折り紙	おりがみ Nghệ thuật xếp giấy CHIẾT, TRIẾT CHỈ
折れる	おれる Bị gẫy,nhượng bộ,chịu thua,rẽ,quẹo CHIẾT, TRIẾT
定規	じょうぎ Cây thước ĐỊNH QUI
困る	こまる Khó khăn KHỐN
消す	けす Tắt,xoá TIÊU
消える	きえる Bị tắt,bị xoá TIÊU
消しゴム	けしゴム Cục tẩy TIÊU
予防	よぼう Phòng ngừa,đề phòng DƯ PHÒNG
救急車	きゅうきゅうしゃ Xe cấp cứu CỨU CẤP XA
警官	けいかん Đồn cảnh sát CẢNH QUAN
警察署	けいさつしょ Đồn cảnh sát CẢNH SÁT THỰ
警察	けいさつ Cảnh sát CẢNH SÁT
事故	じこ Sự cố,tai nan SỰ CỐ
故障	こしょう Hỏng hóc CỐ CHƯỚNG
故～	こ～ ～quá cố,đã mất CỐ
伝言	でんごん Tin nhắn TRUYỀN, TRUYỆN NGÔN
伝える	つたえる Truyền đạt TRUYỀN, TRUYỆN
手伝う	てつだう Giúp đỡ THỦ TRUYỀN, TRUYỆN
消費	しょうひ Sự tiêu thụ,sự tiêu dùng TIÊU PHÍ
賛成	さんせい Tán thành,chấp nhận,đồng ý,ủng hộ TOAN THÀNH
黄色	きいろ Màu vàng HÒANG SẮC
絵画	かいが Bức tranh,hội hoạ HỘI HỌA, HOẠCH
絵	え Tranh HỘI
絵本	えほん Sách tranh HỘI BẢN
～組	～くみ Cặp,đôi TỔ
番組	ばんぐみ Chương trình tivi,kênh tivi PHIÊN TỔ
組む	くむ Hợp tác,bắt cặp,lắp ráp,bắt chéo	chân TỔ
約束	やくそく Lời hứa,cái hẹn ƯỚC THÚC
～束	～たば Bó THÚC
花束	はなたば Bó hoa HOA THÚC
授業	じゅぎょう Tiết học THỤ NGHIỆP
教授	きょうじゅ sự giáo dục, giảng day; Giáo sư GIÁO THỤ
渡る	わたる Băng qua ĐỘ
渡す	わたす Trao cho ĐỘ
昔	むかし Ngày xưa TÍCH
当たり前	あたりまえ Đương nhiên,dĩ nhiên,hợp lý ĐANG, ĐƯƠNG TIỀN
分解	ぶんかい Phân tích,tháo rời,phân giải PHÂN GIẢI
神経質	しんけいしつ 	đặc trưng tính cáchsự nóng nảy,bực dọc,hay lo lắng 	tâm trang không ổn định, gap chuyện nhỏ cũng phản ứng quá lên THẦN KINH CHẤT
差	さ Sự khác biệt,sự cách biệt SAI
差し出す	さしだす Nộp,đưa SAI XUẤT
受験	じゅけん Thi cử,tham gia kì thi THỤ NGHIỆM
産婦人科	さんふじんか Khoa sản SẢN PHỤ NHÂN KHOA
図形	ずけい Sơ đồ,biểu đồ ĐỒ HÌNH
右折	うせつ Rẽ phải HỮU CHIẾT, TRIẾT
左折	させつ Rẽ trái TẢ CHIẾT, TRIẾT
消防	しょうぼう Cứu hoả,chữa cháy TIÊU PHÒNG
防ぐ	ふせぐ Phòng chống,đề phòng PHÒNG
救う	すくう Cứu,cứu sống,cứu giúp CỨU
故	こ Người cũ,người trước,người đã chết CỐ
組み立てる	くみたてる Cấu thành,lắp ráp TỔ LẬP
必要	ひつよう Cần thiết TẤT YÊU, YẾU
要る	いる Cần YÊU, YẾU
重要	じゅうよう Quan trọng TRỌNG, TRÙNG YÊU, YẾU
冷房	れいぼう Điều hoà LÃNH PHÒNG
冷たい	つめたい Lạnh,lạnh nhạt,nhạt nhẽo LÃNH
冷やす	ひやす Làm lạnh,làm đông lại,ướp lạnh LÃNH
冷える	ひえる Lạnh đi,nguội đi LÃNH
冷める	さめる Nguội,nguội đi LÃNH
冷ます	さます Làm mát,làm nguội,làm nản chí,cụt hứng LÃNH
冷蔵庫	れいぞうこ Tủ lạnh LÃNH TÀNG KHỐ
冷凍庫	れいとうこ Tủ đông lạnh LÃNH ĐỐNG KHỐ
凍る	こおる Đóng băng,đông lại ĐỐNG
金庫	きんこ Két sắt KIM KHỐ
召し上がる	めしあがる Ăn 	Kính ngữ TRIỆU THƯỢNG
保存する	ほぞんする Bảo quản,giữ gìn BẢO TỒN
ご存じです	ごぞんじです Biết	kính ngữ TỒN
存じません	ぞんじません Không biết TỒN
必ず	かならず Nhất định TẤT
必死（に）	ひっし（に） Liều lĩnh,dữ dội,điên cuồng TẤT TỬ
費用	ひよう Chi phí,phí tổn PHÍ DỤNG
消費者	しょうひしゃ Người tiêu dùng TIÊU PHÍ GIẢ
会費	かいひ Hội phí HỘI PHÍ
期間	きかん Thời kì,thời hạn KỲ GIAN, GIÁN
長期	ちょうき Thời gian dài TRƯỜNG, TRƯỞNG KỲ
定期券	ていきけん Vé định kì,vé tháng ĐỊNH KỲ KHÓAN
短期	たんき Thời gian ngắn ĐỎAN KỲ
期限	きげん Thời hạn KỲ HẠN
限度	げんど Giới hạn HẠN ĐỘ
限る	かぎる Giới hạn,hạn chế HẠN
限定	げんてい Sự hạn định,sự hạn chế,sự qui định giới hạn HẠN ĐỊNH
～製	～せい Được làm bằng,tại 	nhật,việt nam... CHẾ
製品	せいひん Sản phẩm,hàng hoá,mặt hàng CHẾ PHẨM
造る	つくる Tạo TẠO
賞	しょう Giải thưởng THƯỞNG
賞味期限	しょうみきげん Thời hạn sử dụng THƯỞNG VỊ KỲ HẠN
方法	ほうほう Phương pháp PHƯƠNG PHÁP
文法	ぶんぽう Ngữ pháp VĂN PHÁP
温度	おんど Nhiệt độ,độ nóng ÔN ĐỘ
気温	きおん Nhiệt độ không khí KHÍ ÔN
暖かい	あたたかい Ấm NÕAN
常温	じょうおん Nhiệt độ bình thường THƯỜNG ÔN
同窓会	どうそうかい Hội cựu sinh viên ĐỒNG SONG HỘI
販売	はんばい Buôn bán,kinh doanh PHÁN MẠI
自動販売機	じどうはんばいき Máy bán hàng tự động TỰ ĐỘNG PHÁN MẠI CƠ
飛行機	ひこうき Máy bay KHIÊU	PHI HÀNH, HÀNG, HẠNH CƠ
機械	きかい Máy móc CƠ GIỚI
機会	きかい Cơ hội CƠ HỘI
増加	ぞうか Tăng TĂNG GIA
増える	ふえる Gia tăng,tăng lên TĂNG
増やす	ふやす Tăng thêm,tăng vào TĂNG
減少	げんしょう Giảm đi,giảm bớt GIẢM THIỂU, THIẾU
減る	へる Giảm đi GIẢM
減らす	へらす Giảm xuống,cắt bớt,giảm xuống GIẢM
量	りょう Số lượng LƯỢNG
数量	すうりょう Số lượng,khối lượng SỐ LƯỢNG
氷	こおり Đá BĂNG
返事	へんじ Trả lời PHẢN SỰ
返す	かえす Trả lại PHẢN
お湯	おゆ Nước sôi THANG
材料	ざいりょう Nguyên liệu,vật liệu TÀI LIỆU
教材	きょうざい Giáo trình giảng dạy GIÁO TÀI
卵	たまご Trứng NÕAN
卵焼き	たまごやき Món trứng nướng NÕAN THIÊU
牛乳	ぎゅうにゅう Sữa bò NGƯU NHŨ
粉	こな Bột PHẤN
袋	ふくろ Cái bao,cái túi ĐẠI
紙袋	かみぶくろ Túi giấy CHỈ ĐẠI
ゴミ袋	ゴミふくろ Túi rác ĐẠI
手袋	てぶくろ Bao tay THỦ ĐẠI
足袋	たび Tất kiểu Nhật TÚC ĐẠI
混雑	こんざつ Đông đúc,tắt nghẽn HỖN TẠP
混ぜる	まぜる Trộn,trộn lẫn,pha trộn HỖN
焼く	やく Nướng,quay,đốt THIÊU
焼ける	やける Bị đốt,bị cháy,được nướng THIÊU
表	おもて Cái bảng,danh sách BIỂU
表面	ひょうめん Bề mặt,bề ngoài,bên ngoài BIỂU DIỆN
発表	はっぴょう Phát biểu PHÁT BIỂU
代表	だいひょう Đại diện,đại biểu ĐẠI BIỂU
表す	あらわす Biểu thị,biểu hiện BIỂU
裏	うら Mặt sau,phía sau LÝ
裏返す	うらがえす Lật úp,lộn ngược LÝ PHẢN
留学	りゅうがく Du học LƯU HỌC
書留	かきとめ Thư bảo đảm THƯ LƯU
留める	とめる Ghim,băng,buộc,kẹp lại LƯU
留守	るす Vắng nhà LƯU THỦ, THÚ
守る	まもる Bảo vệ THỦ, THÚ
濃い	こい Đậm NÙNG
薄い	うすい Nhạt BẠC
部分	ぶぶん Phần,bộ phận BỘ PHÂN
学部	がくぶ Khoa,ban,bộ môn HỌC BỘ
部長	ぶちょう Trưởng phòng BỘ TRƯỜNG, TRƯỞNG
部屋	へや Căn phòng BỘ ỐC
数字	すうじ Số SỐ TỰ
数学	すうがく Môn toán SỐ HỌC
数	かず Số SỐ
数える	かぞえる Đếm SỐ
件名	けんめい Chủ đề KIỆN DANH
事件	じけん Sự kiện,vụ việc SỰ KIỆN
用件	ようけん Công chuyện,công việc DỤNG KIỆN
再入国	さいにゅうこく Tái nhập cư TÁI NHẬP QUỐC
再来週	さらいしゅう Tuần sau nữa TÁI LAI CHU
接続	せつぞく Kết nối TIẾP TỤC
面接	めんせつ Phỏng vấn DIỆN TIẾP
続く	つづく Tiếp tục,kéo dài TỤC
続ける	つづける Tiếp tục,làm tiếp TỤC
表示	ひょうじ Biểu thị BIỂU THỊ
指示	しじ Chỉ thị,hướng dẫn CHỈ	SÁP, THÁP THỊ
示す	しめす Chỉ,tỏ ra,cho thấy THỊ
戻る	もどる Quay lại,trở lại LỆ
戻す	もどす Quay lại,phục hồi lại,hoàn lại,trả lại LỆ
完了	かんりょう Hoàn thành,làm xong HÒAN LIỄU
完全	かんぜん Hoàn thành,hoàn hảo,hoàn toàn HÒAN TÒAN
了解	りょうかい Hiểu,đồng ý,ưng thuận LIỄU GIẢI
終了	しゅうりょう Kết thúc,chấm dứt,làm xong CHUNG LIỄU
登録	とうろく Đăng kí ĐĂNG LỤC
登山	とざん Leo núi ĐĂNG SƠN
登る	のぼる Leo,trèo lên ĐĂNG
記録	きろく Kỉ lục KÝ LỤC
教育	きょういく Giáo dục GIÁO DỤC
育てる	そだてる Nuôi nấng,dạy dỗ DỤC
育つ	そだつ Lớn lên DỤC
種類	しゅるい Loại,hạng,thứ CHỦNG LOẠI
書類	しょるい Tài liệu THƯ LOẠI
教師	きょうし Giáo viên GIÁO SƯ
医師	いし Bác sĩ Y SƯ
看護師	かんごし Y tá KHÁN HỘ SƯ
夫妻	ふさい Vợ chồng PHU THÊ
妻	つま Vợ mình THÊ
馬	うま Con ngựa MÃ
乗馬	じょうば Sự cởi ngựa THỪA, THẶNG MÃ
石けん	せっけん Xà phòng THẠCH
石油	せきゆ Dầu hoả,dầu lửa THẠCH DU
石	いし Đá THẠCH
車庫	しゃこ Chỗ để xe XA KHỐ
必死	ひっし Điên cuồng,liều lĩnh TẤT TỬ
旅費	りょひ Phí đi lại,phí vận chuyển LỮ PHÍ
製造	せいぞう Sản xuất,chế tạo CHẾ TẠO
賞金	しょうきん Tiền thưởng THƯỞNG KIM
賞品	しょうひん Phần thưởng,giải thưởng,cúp THƯỞNG PHẨM
増量	ぞうりょう Sự tăng số lượng TĂNG LƯỢNG
減量	げんりょう Sự giảm số lượng GIẢM LƯỢNG
返却	へんきゃく Sự trả lại,sự hoàn trả PHẢN KHƯỚC
小麦粉	こむぎこ Bột mì TIỂU MẠCH PHẤN
保留	ほりゅう Bảo lưu,giữ lại,để lại BẢO LƯU
留守番	るすばん Sự trông coi nhà giùm LƯU THỦ, THÚ PHIÊN
守備	しゅび Bảo vệ,phòng thủ,canh gác THỦ, THÚ BỊ
再生	さいせい Sử dụng lại TÁI SINH
再ダイヤル	さいダイヤル Gọi lại TÁI
録音	ろくおん Ghi âm,thu âm LỤC ÂM
録画	ろくが Ghi video LỤC HỌA, HOẠCH
種	たね Hạt giống CHỦNG
分類	ぶんるい Phân loại PHÂN LOẠI
人類	じんるい Nhân loại NHÂN LOẠI
砂糖	さとう Đường SA ĐƯỜNG
砂	すな Hạt cát SA
塩	しお Muối DIÊM
しょう油	しょうゆ Nước tương DU
石油	せきゆ Dầu hoả,dầu lửa THẠCH DU
油	あぶら Dầu DU
緑	みどり Màu xanh của cây cối LỤC
紅茶	こうちゃ Hồng trà HỒNG TRÀ
口紅	くちべに Son môi KHẨU HỒNG
～冊	～さつ Quyển	Dùng để đếm sách,báo,tạp chí SÁCH
～個	～こ Cái,chiếc 	dùng để đếm vật hình khồi hoặc chung chung CÁ
個人	こじん cá nhân; mang tính cá nhân; riêng tư; riêng CÁ NHÂN
個数	こすう số vật 	item CÁ SỐ
団体	だんたい Đoàn thể,tập thể ĐÒAN THỂ
～枚	～まい Tấm,tờ	dùng để đếm những vật mỏng MAI
枚数	まいすう Số tờ,số tấm MAI SỐ
部数	ぶすう Số lượng bản sao BỘ SỐ
広告	こうこく Quảng cáo QUẢNG CÁO
便利	べんり Tiện lợi TIỆN LỢI
利用	りよう Sử dụng LỢI DỤNG
割る	わる Làm vỡ,đập vỡ CÁT
割れる	われる Gãy,đứt,vỡ,vỡ tan CÁT
割合	わりあい Tỷ lệ,phần trăm CÁT HỢP
割引	わりびき Giảm giá CÁT DẪN
～倍	～ばい Gấp ～ lần BỘI
値段	ねだん Giá TRỊ ĐỌAN
値上げ	ねあげ Sự tăng giá TRỊ THƯỢNG
値下げ	ねさげ Sự hạ giá TRỊ HẠ
商品	しょうひん Hàng hoá THƯƠNG PHẨM
商店	しょうてん Cửa hàng THƯƠNG ĐiẾM
支店	してん Chi nhánh CHI ĐiẾM
本店	ほんてん Trụ sở chính BẢN ĐiẾM
支社	ししゃ Công ty con CHI XÃ
本社	ほんしゃ Công ty mẹ BẢN XÃ
払う	はらう Trả,trả tiền PHẤT
支払い	しはらい Sự trả tiền,sự nộp tiền CHI PHẤT
米国	べいこく Nước Mỹ MỄ QUỐC
米	べい Gạo MỄ
高級	こうきゅう Cao cấp CAO CẤP
中級	ちゅうきゅう Trung cấp TRUNG, TRÚNG CẤP
上級	じょうきゅう Thượng cấp THƯỢNG CẤP
残業	ざんぎょう Tăng ca,làm thêm giờ TÀN NGHIỆP
残り	のこり Còn lại,vật còn lại,phần còn lại TÀN
残る	のこる Còn lại,ở lại TÀN
残す	のこす Để lại,để dành TÀN
大型	おおがた Kích cỡ lớn,loại lớn ĐẠI HÌNH
小型	こがた Kích cỡ nhỏ,loại nhỏ TIỂU HÌNH
新型	しんがた Kiểu mới TÂN HÌNH
消費税	しょうひぜい Thuế tiêu dùng TIÊU PHÍ THUẾ
税金	ぜいきん Thuế THUẾ KIM
込む	こむ Đông đúc VÀO
振り込む	ふりこむ Chuyển khoản ngân hàng CHẤN VÀO
価格	かかく Giá GIÁ CÁCH
定価	ていか Giá cố định ĐỊNH GIÁ
合格	ごうかく Đậu,đỗ HỢP CÁCH
申し込む	もうしこむ Đăng ký THÂN VÀO
申す	もうす Nói là, được gọi là, tên là THÂN
申し上げる	もうしあげる Nói,bày tỏ,diễn tả THÂN THƯỢNG
記入	きにゅう Điền vào KÝ NHẬP
日記	にっき Nhật kí NHẬT KÝ
記号	きごう Kí hiệu KÝ HIỆU
記事	きじ Bài bài,phóng sự KÝ SỰ
例	れい Ví dụ LỆ
例えば	たとえば Ví dụ,thí dụ LỆ
年齢	ねんれい Tuổi,tuổi tác NIÊN LINH
高齢	こうれい Tuổi cao,tuổi già CAO LINH
～歳	～とし ～ tuổi TUẾ
性別	せいべつ Giới tính TÍNH BIỆT
性格	せいかく Tính cách TÍNH CÁCH
女性	じょせい Nữ giới NỮ TÍNH
男性	だんせい Nam giới NAM TÍNH
連休	れんきゅう Kì nghỉ dài LIÊN HƯU
連れて行く	つれていく Dắt theo, đưa theo, đưa đi cùng LIÊN HÀNH, HÀNG, HẠNH
連れて来る	つれてくる Đưa đến,dắt đến LIÊN LAI
連絡	れんらく Liên lạc LIÊN LẠC
届ける	とどける Giao,đưa đến,chuyển đến,trình báo GIỚI
届く	とどく Được giao tới,đạt được GIỚI
自宅	じたく Nhà mình TỰ TRẠCH
お宅	おたく Nhà ông,nhà bà	kính ngữ TRẠCH
配達	はいたつ Phân phối,giao hàng PHỐI ĐẠT
配送料	はいそうりょう Phí giao hàng PHỐI TỐNG LIỆU
心配	しんぱい Lo lắng TĂM PHỐI
配る	くばる Phân phát PHỐI
希望	きぼう Hy vọng HY VỌNG
望む	のぞむ Cần,mong muốn,hy vọng VỌNG
入荷	にゅうか Nhập hàng NHẬP HÀ
出荷	しゅっか Xuất hàng XUẤT HÀ
荷物	にもつ Hành lý HÀ VẬT
手荷物	てにもつ Hành lý xách tay THỦ HÀ VẬT
交換	こうかん Trao đổi GIAO HÓAN
代金引換	だいきんひきかえ Trả tiền khi giao hàng ĐẠI KIM DẪN HÓAN
乗り換え	のりかえ Đổi xe,tàu THỪA, THẶNG HÓAN
代引き	だいびき Trả tiền khi giao hàng ĐẠI DẪN
金額	きんがく Số tiền KIM NGẠCH
半額	はんがく Nửa giá BÁN NGẠCH
合計	ごうけい Tổng cộng HỢP KẾ
現在	げんざい Hiện tại,hiện giờ,hiện nay HIỆN TẠI
取る	とる Lấy,cầm,giữ THỦ
受け取る	うけとる Nhận,tiệp nhận THỤ THỦ
受取人	うけとりにん Người nhận THỤ THỦ NHÂN
預ける	あずける Gởi,kí gởi,giao phó DỰ
参加	さんか Tham gia TAM, THAM GIA
参考書	さんこうしょ Sách tham khảo TAM, THAM KHẢO THƯ
参る	まいる Đi,đến 	khiêm nhường ngữ TAM, THAM
友達	ともだち Bạn bè HỮU ĐẠT
通勤	つうきん Đi làm THÔNG CẦN
勤める	つとめる Làm việc CẦN
携帯電話	けいたいでんわ Điện thoại di động HUỀ ĐỚI, ĐÁI ĐiỆN THOẠI
細い	ほそい Mỏng,ốm TẾ
細かい	こまかい Chi tiết,kĩ lưỡng TẾ
戸	と Cửa HỘ
雨戸	あまど Cửa che mưa VŨ HỘ
戸だな	とだな Tủ quần áo,tủ HỘ
びわ湖	びわこ Hồ Biwa HỒ
湖	みずうみ Hồ HỒ
船	ふね Thuyền BÁCH	THUYỀN
船便	ふなびん Gởi bằng đường tàu BÁCH	THUYỀN TIỆN
四角い	しかくい Hình tứ giác TỨ GIÁC
角	かど Góc GIÁC
夫婦	ふうふ Vợ chồng PHU PHỤ
夫妻	ふさい Vợ chồng,phu thê PHU THÊ
夫	おっと Chồng mình PHU
苦労	くろう Gian khổ,cam go,khó khăn KHỔ LAO
苦しい	くるしい Khổ cực KHỔ
苦い	にがい Đắng KHỔ
苦手	にがて Yếu,kém KHỔ THỦ
食塩	しょくえん Muối ăn THỰC DIÊM
灯油	とうゆ Dầu hoả,dầu lửa ĐĂNG DU
緑茶	りょくちゃ Chè xanh,chè tươi LỤC TRÀ
冊数	さっすう Số bản copy SÁCH SỐ
格安	かくやす Giá rẻ CÁCH AN, YÊN
税込み	ぜいこみ Bao gồm thuế THUẾ VÀO
申告	しんこく Khai báo THÂN CÁO
申込書	もうしこみしょ Form đăng kí THÂN VÀO THƯ
申請	しんせい Yêu cầu,thỉnh cầu THÂN THỈNH
宅配	たくはい Giao hàng đến tận nhà TRẠCH PHỐI
配送料	はいそうりょう Phí chuyển hàng PHỐI TỐNG LƯỢNG
失望	しつぼう Thất vọng,nản chí THẤT VỌNG
不在	ふざい Vắng mặt BẤT TẠI
預金	よきん Tiền gởi,tiền tiết kiệm DỰ KIM
衣類	いるい Quần áo 	thường bao gồm giày, dép, vớ, đồ lót.... Y LOẠI
衣服	いふく Quần áo 	thường chỉ quần áo bên ngoài thôi Y PHỤC
上達	じょうたつ Tiến bộ,tiến triển,cải thiện THƯỢNG ĐẠT
速達	そくたつ Sự chuyển phát nhanh,sự giao hàng nhanh TỐC ĐẠT
帯	おび Thắt lưng ĐỚI, ĐÁI
時間帯	じかんたい Khoảng thời gian THỜI, THÌ GIAN, GIÁN ĐỚI, ĐÁI
戸棚	とだな Tủ búp phê,tủ âm tường HỘ BẰNG, BÀNH
風船	ふうせん Khí cầu PHONG BÁCH	THUYỀN
船長	せんちょう Thuyền trưởng BÁCH	THUYỀN TRƯỜNG, TRƯỞNG
角度	かくど Góc,góc độ GIÁC ĐỘ
三角形	さんかっけい Hình tam giác TAM GIÁC HÌNH
お礼	おれい Cảm ơn LỄ
伺う	うかがう Thăm,hỏi 	khiêm nhường ngữ TỨ
遅刻	ちこく Đi trễ,muộn TRÌ KHẮC
遅い	おそい Trễ,muộn TRÌ
遅れる	おくれる Trễ,chậm trễ TRÌ
失礼	しつれい Thất lễ THẤT LỄ
失敗	しっぱい Thất bại THẤT BẠI
失礼する	しつれいする Xin lỗi THẤT LỄ
汗	あせ Mồ hôi HÃN
汗をかく	あせをかく Đổ mồ hôi,chảy mồ hôi HÃN
残念	ざんねん Đáng tiếc TÀN NiỆM
記念	きねん Kỉ niệm KÝ NiỆM
涙	なみだ Nước mắt LỤY, LỆ
涙を流す	なみだをながす Chảy nước mắt LỤY, LỆ LƯU
笑う	わらう Cười TiẾU
笑い	わらい Cười TiẾU
笑顔	えがお Vẻ mặt tươi cười TiẾU NHAN
調子	ちょうし Tình trạng 	sức khoẻ,máy móc ĐiỀU, ĐiỆU TỬ, TÝ
強調	きょうちょう Nhấn mạnh CƯỜNG, CƯỠNG	MiỄN ĐiỀU, ĐiỆU
調べる	しらべる Điều tra,kiểm tra ĐiỀU, ĐiỆU
調査	ちょうさ Điều tra ĐiỀU, ĐiỆU TRA
移る	うつる Di chuyển,chuyển sang,chuyển DI
移す	うつす Dọn đi,làm di chuyển,chuyển DI
困難	こんなん Khó khăn KHỐN NẠN
難しい	むずかしい Khó NẠN
簡単	かんたん Đơn giản GIẢN ĐƠN, ĐAN
単語	たんご Từ vựng ĐƠN, ĐAN NGỮ
単位	たんい Đơn vị,tín chỉ	ở trường đại học ĐƠN, ĐAN VỊ
感じる	かんじる Cảm thấy CẢM
感動	かんどう Cảm động CẢM ĐỘNG
感想	かんそう Cảm tưởng CẢM TƯỞNG
予想	よそう Dự báo DƯ TƯỞNG
強力	きょうりょく Mạnh mẽ,hùng mạnh CƯỜNG, CƯỠNG	MiỄN LỰC
練習	れんしゅう Luyện tập LUYỆN TẬP
最近	さいきん Dạo gần đây TỐI CÂ?N
最初	さいしょ Đầu tiên,lúc đầu TỐI SƠ
最後	さいご Cuối cùng,sau cùng TỐI HẬU
最も	もっとも Nhất là TỐI
適当	てきとう Thích hợp,đúng THÍCH ĐANG, ĐƯƠNG
快適	かいてき Sảng khoái,dễ chịu,thoải mái KHÓAI THÍCH
選挙	せんきょ Cuộc bầu cử,cuộc tuyển cử THIÊN	TUYỂN CỬ
選手	せんしゅ Vận động viên THIÊN	TUYỂN THỦ
選ぶ	えらぶ Chọn,lựa chọn THIÊN	TUYỂN
違う	ちがう Sai,khác VI	VĨ
間違い	まちがい Lỗi lầm,nhầm lẫn GIAN, GIÁN VI	VĨ
間違う	まちがう Gây lỗi,nhầm lẫn GIAN, GIÁN VI	VĨ
（を）間違える	（を）まちがえる Gây lỗi,nhầm lẫn GIAN, GIÁN VI	VĨ
直接	ちょくせつ Trực tiếp TRỰC TIẾP
直る	なおる Được sửa,được chữa TRỰC
直す	なおす Chỉnh,sửa,dịch TRỰC
復習	ふくしゅう Ôn tập PHỤC TẬP
往復	おうふく Khứ hồi VÃNG PHỤC
回復	かいふく Phục hồi HỒI PHỤC
辞書	じしょ Từ điển TỪ THƯ
辞める	やめる Nghỉ hưu,thôi việc TỪ
宿題	しゅくだい Bài tập TÚ, TÚC ĐỀ
宿	やど Chỗ trọ,chỗ tạm trú TÚ, TÚC
下宿	げしゅく Ở trọ HẠ TÚ, TÚC
昨日	きのう Hôm qua TẠC NHẬT
昨日	さくじつ Hôm qua TẠC NHẬT
昨夜	さくや Tối qua TẠC DẠ
昨年	さくねん Năm ngoái TẠC NIÊN
～君	～くん Cậu,bé ～ QUÂN
君	きみ Em QUÂN
結構	けっこう Tạm được,tương đối,khá khá KẾT CẤU
結局	けっきょく Cuối cùng,rốt cuộc KẾT CỤC
結婚	けっこん Kết hôn KẾT HÔN
新婚旅行	しんこんりょこう Tuần trang mặt TÂN HÔN LỮ HÀNH, HÀNG, HẠNH
お祝い	おいわい Sự chúc mừng,đồ mừng CHÚC
曲	きょく Bài hát KHÚC
曲がる	まがる Rẽ,quẹo KHÚC
奥さん	おくさん Vợ người khác
奥	おく Bên trong
寝る	ねる Ngủ TẨM
寝坊	ねぼう Sự ngủ dậy muộn TẨM PHƯỜNG
昼寝	ひるね Ngủ trưa TRÚ TẨM
頭痛	ずつう Đau đầu ĐẦU THỐNG
痛い	いたい Đau THỐNG
熱い	あつい Nóng,nóng bỏng,oai bức NHIỆT
熱心	ねっしん Nhiệt tình NHIỆT TĂM
虫	むし Côn trùng TRÙNG
歯科	しか Nha khoa XỈ KHOA
歯	は Răng XỈ
歯医者	はいしゃ Nha sĩ XỈ Y GIẢ
虫歯	むしば Răng sâu TRÙNG XỈ
政治	せいじ Chính trị CHÍNH TRỊ
治る	なおる Lành,khôi phục TRỊ
治す	なおす Chữa bệnh TRỊ
汚い	きたない Dơ,bẩn Ô
汚れる	よごれる Bị bẩn,nhiễm bẩn Ô
並ぶ	ならぶ Đứng thành hàng,xếp hàng BÍNH
並べる	ならべる Bài trí,bày đặt BÍNH
歯並び	はならび Sự sắp xếp của răng XỈ BÍNH
他の	たの Khác THA
その他	そのた Khác THA
独身	どくしん Độc thân ĐỘC THÂN
刺身	さしみ Món Sasimi THÍCH THÂN
日本酒	にほんしゅ Rượu Nhật NHẬT BẢN TỬU
料理酒	りょうりしゅ Rượu Nhật để nấu ăn LIỆU LÝ TỬU
お酒	おさけ Rượu TỬU
酒屋	さかや Tiệm rượu TỬU ỐC
吸う	すう Hít,hút HẤP
食欲	しょくよく Thèm ăn THỰC DỤC
欲しい	ほしい Muốn 	ý muốn của mình và người ở ngôi thứ 3 DỤC
睡眠	すいみん Giấc ngủ THỤY MIÊN
眠い	ねむい Buồn ngủ MIÊN
眠る	ねむる Ngủ MIÊN
疲れる	つかれる Mệt mỏi BÌ
息	いき Hơi thở TỨC
息子	むすこ Con trai TỨC TỬ, TÝ
呼ぶ	よぶ Gọi,mời,kêu tên HÔ
厚い	あつい Dày HẬU
泣く	なく Khóc KHẤP
鳴く	なく Kêu,hót,hú MINH
鳴る	なる Reo 	chuông điện thoại... MINH
初級	しょきゅう Sơ cấp SƠ CẤP
初め	はじめ Ban đầu,lần đầu,khởi đầu SƠ
初めて	はじめて Lần đầu tiên,lần đầu SƠ
泊まる	とまる Trú lại,ở lại BẠC
泊める	とめる Cho lưu trú,lưu lại,giữ lại BẠC
紅葉	こうよう Cây lá đỏ HỒNG DIỆP
葉	は Lá DIỆP
言葉	ことば Từ vựng NGÔN DIỆP
移動	いどう Chuyển động,vận chuyển DI ĐỘNG
難問	なんもん Vấn đề nan giải,câu hỏi khó NẠN VẤN
直線	ちょくせん Tuyến đường thẳng TRỰC TUYẾN
結ぶ	むすぶ Nối,ràng buộc,cột,buộc KẾT
婚約	こんやく Đính hôn HÔN ƯỚC
祝日	しゅくじつ Ngày lễ,ngày quốc khánh CHÚC NHẬT
祝う	いわう Ăn mừng,chúc mừng CHÚC
曲線	きょくせん Đường cong,đường vòng KHÚC TUYẾN
曲げる	まげる Uốn cong,bẻ cong KHÚC
腹痛	ふくつう Đau bụng PHÚC THỐNG
熱	ねつ Cơn sốt,độ sốt NHIỆT
治療	ちりょう Trị liệu,điều trị TRỊ LiỆU
身長	しんちょう Chiều cao THÂN TRƯỜNG, TRƯỞNG
身分	みぶん Vị trí xã hội,địa vị,thân phận THÂN PHÂN
呼吸	こきゅう Sự hô hấp,sự hít thở HÔ HẤP
意欲	いよく Hăng hái,động lực,ý muộn Ý DỤC
息切れ	いきぎれ Sự hết hơi,sự hụt hơi TỨC THIẾT
予報	よほう Dự báo DƯ BÁO
報告	ほうこく Thông báo BÁO CÁO
晴れる	はれる Trời nắng TÌNH
晴れ	はれ Trời nắng TÌNH
雲	くも Mây VÂN
吹く	ふく Thổi XUY
暖房	だんぼう Lò sưởi NÕAN PHÒNG
暖かい	あたたかい Ấm áp NÕAN
雪	ゆき Tuyết TUYẾT
地震	じしん Động đất ĐỊA CHẤN
震度	しんど Độ chấn động,độ động đất CHẤN ĐỘ
波	なみ Con sóng BA
津波	つなみ Sóng thần TÂN BA
求める	もとめる Mong muốn,yêu cầu,tìm kiếm CẦU
募集	ぼしゅう Tuyển dụng MỘ TẬP
職場	しょくば Nơi làm việc CHỨC TRƯỜNG, TRÀNG
職業	しょくぎょう Nghề nghiệp CHỨC NGHIỆP
転職	てんしょく Thay đổi công việc CHUYỂN CHỨC
職員	しょくいん Công nhân CHỨC VIÊN
美容院	びよういん Thẩm mỹ viện MỸ DUNG ViỆN
内容	ないよう Nội dung NỘI DUNG
技術	ぎじゅつ Kĩ thuật,công nghệ KỸ THUẬT
技術者	ぎじゅつしゃ Kĩ sư KỸ THUẬT GIẢ
一般	いっぱん Cái chung,thông thường,bình thường NHẤT BAN
一般に	いっぱんに Nói chung NHẤT BAN
事務	じむ Công việc văn phòng SỰ VỤ
公務員	こうむいん Công chức nhà nước CÔNG VỤ VIÊN
事務所	じむしょ Văn phòng SỰ VỤ SỞ
第一課	だいいっか Bài 1 ĐỆ NHẤT KHÓA
課長	かちょう Trưởng ban KHÓA TRƯỜNG, TRƯỞNG
地球	ちきゅう Địa cầu ĐỊA CẦU
野球	やきゅう Bóng chày DÃ CẦU
決して	けっして Không bao giờ,quyết...không QUYẾT
決定	けってい Quyết định QUYẾT ĐỊNH
（を）決める	きめる Quyết định QUYẾT
（が）決まる	（が）きまる Quyết định QUYẾT
優勝	ゆうしょう Vô địch ƯU THẮNG
決勝	けっしょう Trận chung kết QUYẾT THẮNG
勝つ	かつ Thắng,đánh bại THẮNG
１対２	１たい２ Tỷ số 2	1 ĐỐI
反対	はんたい Phản đối,ngược lại PHẢN ĐỐI
（が）流れる	ながれる Chảy LƯU
（を）流す	（を）ながす Cho chảy LƯU
勝負	しょうぶ Sự thắng hay thua THẮNG PHỤ
負ける	まける Thua,thất bại PHỤ
投げる	なげる Ném ĐẦU
結果	けっか Kết quả KẾT QUẢ
果物	くだもの Trái cây QUẢ VẬT
戦争	せんそう Chiến tranh CHIẾN TRANH
戦う	たたかう Chiến đấu CHIẾN
経験	けいけん Kinh nghiệm KINH NGHIỆM
経営	けいえい Kinh doanh KINH DOANH, DINH
経済	けいざい Kinh tế KINH TẾ
済む	すむ Kết thúc,hoàn tất TẾ
成長	せいちょう Trưởng thành THÀNH TRƯỜNG, TRƯỞNG
完成	かんせい Hoàn thành HÒAN THÀNH
貿易	ぼうえき Thương mại MẬU DỊ, DỊCH
易しい	やさしい Dễ,dễ dàng,đơn giản DỊ, DỊCH
輸出	ゆしゅつ Xuất khẩu DU XUẤT
輸入	ゆにゅう Nhập khẩu DU NHẬP
相談	そうだん Thảo luận TƯƠNG, TƯỚNG ĐÀM
首相	しゅしょう Thủ tướng THỦ TƯƠNG, TƯỚNG
相手	あいて Đối phương TƯƠNG, TƯỚNG THỦ
文化	ぶんか Văn hoá VĂN HÓA
～化	～か Văn hoá ～ HÓA
化学	かがく Hoá học HÓA HỌC
化粧	けしょう Trang điểm HÓA TRANG
比べる	くらべる So sánh TỶ
原料	げんりょう Nguyên liệu NGUYÊN LIỆU
原因	げんいん Nguyên nhân NGUYÊN NHÂN
国際	こくさい Quốc tế QUỐC TẾ
会議	かいぎ Cuộc họp HỘI NGHỊ
生活	せいかつ Cuộc sống,sinh hoạt SINH HỌAT
活動	かつどう Hoạt động HỌAT ĐỘNG
大変	たいへん Khó khăn,vất vả,vô cùng,rất ĐẠI BiẾN
変化	へんか Thay đổi BiẾN HÓA
変える	かえる Thay đổi BiẾN
変わる	かわる Thay đổi BiẾN
政治家	せいじか Chính trị gia CHÍNH TRỊ GIA
政府	せいふ Chính phủ CHÍNH PHỦ
都道府県	とどうふけん Sự phân chia hành chính của Nhật ĐÔNG ĐẠO PHỦ HUYỆN
改札口	かいさつぐち Cửa soát vé CẢI TRÁT KHẨU
否定的	ひていてき Phủ định PHỦ ĐỊNH ĐÍCH
目的	もくてき Mục đích,mục tiêu MỤC ĐÍCH
国際的	こくさいてき Tính quốc tế QUỐC TẾ ĐÍCH
個人的	こじんてき Tính cá nhân CÁ NHÂN ĐÍCH
実際に	じっさいに Thật ra là,trong thực tế THỰC TẾ
実は	じつは Thật ra 	dùng để trình bày lý do THỰC
実験	じっけん Thực nghiệm THỰC NGHIỆM
欠点	けってん Thiếu sót,khuyết điểm KHUYẾT ĐiỂM
専門	せんもん Chuyên môn CHUYÊN MÔN
専門家	せんもんか Chuyên gia CHUYÊN MÔN GIA
亡くなる	なくなる Mất,chết VONG
多忙	たぼう Rất bận rộn ĐA MANG
忙しい	いそがしい Bận rộn MANG
忘年会	ぼうねんかい Tiệc cuối năm VONG NIÊN HỘI
忘れる	わすれる Quên VONG
忘れ物	わすれもの Vật bị bỏ quên VONG VẬT
文化祭	ぶんかさい Lễ hội văn hoá VĂN HÓA TẾ
お祭り	おまつり Lễ hội TẾ
苦労	くろう Khó khăn,cam go,vất vả KHỔ LAO
労働者	ろうどうしゃ Người lao động LAO ĐỘNG GIẢ
増加	ぞうか Tăng TĂNG GIA
加える	くわえる Thêm vào,gia tăng,làm cho tăng lên GIA
情報	じょうほう Thông tin TÌNH BÁO
表情	ひょうじょう Diện mạo,tình hình,cảnh tượng,vẻ bề ngoài BIỂU TÌNH
電波	でんぱ Sóng điện ĐiỆN BA
要求	ようきゅう Yêu cầu,đòi hỏi,thỉnh cầu YÊU, YẾU CẦU
求人	きゅうじん Sự cần người làm CẦU NHÂN
請求書	せいきゅうしょ Hoá đơn,giấy đòi tiền THỈNH CẦU THƯ
税務署	ぜいむしょ Cục thuế THUẾ VỤ THỰ
電球	でんきゅう Bóng đèn điện ĐiỆN CẦU
投手	とうしゅ Người phát bóng chày ĐẦU THỦ
戦後	せんご Hậu chiến,thời kì sau chiến tranh CHIẾN HẬU
輸送	ゆそう Chuyên chở,vận chuyển DU TỐNG
交際	こうさい Giao du,kết giao GIAO TẾ
議員	ぎいん Thành viên nghị viện NGHỊ VIÊN
改正	かいせい Sửa lại,đổi lại CẢI CHÍNH
改める	あらためる Cải cách,kiểm tra,sửa đổi CẢI
否定	ひてい Phủ định PHỦ ĐỊNH
欠ける	かける Thiếu sót,thiếu KHUYẾT
死亡	しぼう Chết,tử vong TỬ VONG
事情	じじょう Tình hình,sự tình SỰ TÌNH
感情	かんじょう Tình cảm,cảm tính,cảm xúc CẢM TÌNH
禁止	きんし cấm, nghiêm cấm CẤM CHỈ
禁煙	きんえん cấm hút thuốc CẤM YÊN
煙	けむり khói YÊN
安静（な）	あんせい（な） nghỉ ngơi, yên tĩnh AN, YÊN TĨNH
静か	な	しずか（な） yên lặng TĨNH
静まる	しずまる lắng xuống, dịu đi TĨNH
危険（な）	きけん（な） nguy hiểm NGUY HiỂM
危ない	あぶない nguy hiểm NGUY
危うい	あやうい nguy hiểm NGUY
関心	かんしん quan tâm QUAN TĂM
（～に）関する	（～に）かんする về～, liên quan～ QUAN
関わる	かかわる liên quan, về QUAN
関係	かんけい quan hệ QUAN HỆ
係	かかり sự chịu trách nhiện HỆ
係員	かかりいん người chịu trách nhiệm HỆ VIÊN
転落	てんらく sự giáng chức; sự rớt xuống 	địa vị thấp kém CHUYỂN LẠC
落第	らくだい sự trượt, thi trượt LẠC ĐỆ
落ちる	おちる rơi, rụng LẠC
落とす	おとす đánh rơi, đánh rớt LẠC
落石	らくせき đá lở, đá lăn xuống LẠC THẠCH
磁石	じしゃく nam châm TỪ THẠCH
石	いし đá, hòn đá THẠCH
飛行場	ひこうじょう sân bay, phi trường KHIÊU	PHI HÀNH, HÀNG, HẠNH TRƯỜNG, TRÀNG
飛ぶ	とぶ bay, nhảy KHIÊU	PHI
飛び出す	とびだす chạy ra, nhảy ra KHIÊU	PHI XUẤT
駐車場	ちゅうしゃじょう bãi đỗ xe, bãi đậu xe TRÚ XA TRƯỜNG, TRÀNG
駐車	ちゅうしゃ sự đỗ xe TRÚ XA
四捨五入	ししゃごにゅう làm tròn số 	 số thập phân  TỨ XẢ NGŨ NHẬP
捨てる	すてる từ bỏ, vứt XẢ
遊泳	ゆうえい bơi DU VỊNH
遊ぶ	あそぶ chơi, vui chơi DU
水泳	すいえい việc bơi, bơi THỦY VỊNH
泳ぐ	およぐ bơi, bơi lội VỊNH
喫茶店	きっさてん quán cà phê NGẠT, KHIẾT TRÀ ĐiẾM
喫煙所	きつえんじょ chỗ hút thuốc, nơi hút thuốc NGẠT, KHIẾT YÊN SỞ
非～	ひ～ không～ PHI
非常口	ひじょうぐち cửa thoát hiểm PHI THƯỜNG KHẨU
非常に	ひじょうに rất, cực kỳ PHI THƯỜNG
御家族	ごかぞく gia đình 	bạn NGỰ, NGỪ GIA TỘC
御中	おんちゅう kính thưa, kính gửi NGỰ, NGỪ TRUNG, TRÚNG
御手洗い	おてあらい toa	lét, nhà vệ sinh THỦ TiỂN
日常	にちじょう ngày thường, thường ngày NHẬT THƯỜNG
常識	じょうしき bình thường THƯỜNG THỨC
常に	つねに 	phó từ thường thường, luôn THƯỜNG
受験	じゅけん dự thi, tham gia kỳ thi THỤ NGHIỆM
受ける	うける "1. tham dự 	thi/2. tiếp thu, nhận " THỤ
付近	ふきん gần, phụ cận PHÓ CÂ?N
～付き	～つき đính ～ PHÓ
受付	うけつけ quầy lễ tân THỤ PHÓ
日付	ひづけ ngày tháng NHẬT PHÓ
案内	あんない hướng dẫn, chỉ dẫn ÁN NỘI
案	あん đề xuất, phương án ÁN
以内	いない trong vòng DĨ NỘI
社内	しゃない trong công ty XÃ NỘI
～内	～うち trong ～ NỘI
内	うち trong, bên trong NỘI
会議室	かいぎしつ phòng họp, phòng hội nghị HỘI NGHỊ THẤT
不思議（な）	ふしぎ（な） huyền diệu, kỳ ảo BẤT TƯ NGHỊ
議論	ぎろん thảo luận, tranh luận NGHỊ LuẬN
議員	ぎいん nghị viện NGHỊ VIÊN
文化	ぶんか văn hóa VĂN HÓA
化学	かがく hóa học HÓA HỌC
～化	～か ～ hóa 	biến đổi từ một cái gì đó sang cái khác HÓA
温暖化	おんだんか sự nóng lên toàn cầu ÔN NÕAN HÓA
化粧室	けしょうしつ phòng trang điểm HÓA TRANG THẤT
階段	かいだん cầu thang GIAI ĐỌAN
～階	～かい tầng ～ GIAI
段階	だんかい giai đoạn ĐỌAN GIAI
段	だん giai đoạn ĐỌAN
手段	しゅだん "1. phương pháp/2. Thủ đoạn" THỦ ĐỌAN
一段と	いちだんと 	phó từ hơn rất nhiều, hơn một bậc NHẤT ĐỌAN
石段	いしだん cầu thang đá THẠCH ĐỌAN
営業	えいぎょう kinh doanh, bán hàng DOANH, DINH NGHIỆP
放送	ほうそう phát thanh, loan truyền PHÓNG TỐNG
開放	かいほう mở cửa, sự tự do hóa KHAI PHÓNG
開放厳禁	かいほうげんきん nghiêm cấm mở cửa KHAI PHÓNG NGHIÊM CẤM
放す	はなす buông tay, rời tay PHÓNG
押す	おす ấn, nhấn, bấm ÁP
押し入れ	おしいれ tủ âm tường ÁP NHẬP
押さえる	おさえる giữ, bắt giữ ÁP
準備	じゅんび chuẩn bị CHUẨN BỊ
水準	すいじゅん cấp độ, trình độ, mức độ THỦY CHUẨN
準急	じゅんきゅう tàu tốc hành chạy chậm CHUẨN CẤP
準決勝	じゅんけっしょう bán kết, trận bán kết CHUẨN QUYẾT THẮNG
備品	びひん thiết bị BỊ PHẨM
備える	そなえる chuẩn bị, đề phòng BỊ
備え付け（の）	そなえつけ（の） lắp đặt, chuẩn bị sẵn BỊ PHÓ
定員	ていいん sức chứa ĐỊNH VIÊN
定休日	ていきゅうび ngày nghỉ thường kì ĐỊNH HƯU NHẬT
定食	ていしょく suất ăn ĐỊNH THỰC
定規	じょうぎ thước kẻ ĐỊNH QUI
流行	りゅうこう thịnh hành, lưu hành LƯU HÀNH, HÀNG, HẠNH
流れる	ながれる chảy, tôi chảy LƯU
流す	ながす cho chảy, cho chảy đi LƯU
清書	せいしょ bản copy sạch THANH THƯ
清流	せいりゅう dòng chảy sạch THANH LƯU
清い流れ	きよいながれ dòng chảy sạch THANH LƯU
清い	きよい trong sạch THANH
清掃	せいそう quét trước, dọn dẹp trước THANH TẢO
掃く	はく quét, chải TẢO
閉会	へいかい bế mạc hội nghị BẾ HỘI
閉店	へいてん đóng cửa hàng BẾ ĐiẾM
閉まる	しまる đóng, bị đóng chặt BẾ
閉める	しめる đóng BẾ
閉じる	とじる gấp, đóng 	sách  BẾ
点	てん điểm ĐiỂM
～点	～てん ～ điểm ĐiỂM
欠点	けってん khuyết điểm KHUYẾT ĐiỂM
点検	てんけん kiểm điểm ĐiỂM KIỂM
検問	けんもん khảo sát đất đai KIỂM VẤN
地下鉄	ちかてつ tàu điện ngầm, xe điện ngầm ĐỊA HẠ THIẾT
私鉄	してつ đường sắt tư nhân, đường sắt tư doanh TƯ THIẾT
同窓会	どうそうかい hội cùng lớp ĐỒNG SONG HỘI
窓	まど cửa sổ SONG
窓口	まどぐち cửa bán vé SONG KHẨU
切符	きっぷ vé THIẾT PHÙ
精算	せいさん tính toán chính xác TINH TOÁN
精神	せいしん tinh thần, tâm chí TINH THẦN
計算	けいさん tính, tính toán KẾ TOÁN
引き算	ひきざん phép trừ DẪN TOÁN
足し算	たしざん phép tính cộng TÚC TOÁN
改正	かいせい cải chính, chỉnh sửa CẢI CHÍNH
改める	あらためる sửa đổi, cải thiện CẢI
改まる	あらたまる cải biến, sửa đổi CẢI
改札口	かいさつぐち cổng soát vé CẢI TRÁT KHẨU
１万円札	１まんえんさつ tờ tiền 1 vạn yên VẠN VIÊN TRÁT
札	さつ thẻ, nhãn TRÁT
下線	かせん gạch chân HẠ TUYẾN
線路	せんろ đường ray, đường sắt TUYẾN LỘ
新幹線	しんかんせん tàu siêu tốc TÂN CÁN TUYẾN
時刻	じこく lúc, thời khắc THỜI, THÌ KHẮC
刻む	きざむ thái 	 rau, quả  KHẮC
番号	ばんごう số hiệu PHIÊN HIỆU
～番線	～ばんせん tuyến số ~ PHIÊN TUYẾN
符号	ふごう nhãn, phù hiệu PHÙ HIỆU
～号車	～ごうしゃ toa xe số ~ HIỆU XA
信号	しんごう đèn giao thông TÍN HIỆU
快速	かいそく một loại tàu siêu tốc 	 chậm hơn shinkansen KHÓAI TỐC
快い	こころよい dễ chịu, thoải mái KHÓAI
時速	じそく tốc độ tính theo giờ THỜI, THÌ TỐC
早速	さっそく ngay lập tức TẢO TỐC
速い	はやい nhanh chóng TỐC
道路	どうろ con đường ĐẠO LỘ
通路	つうろ đường đi, lối đi THÔNG LỘ
空港	くうこう sân bay KHÔNG CẢNG
港	みなと cảng CẢNG
理由	りゆう lý do LÝ DO
不自由（な）	ふじゆう（な） không tự do, bị tàn phế BẤT TỰ DO
経由	けいゆ sự thông qua 	 thủ tục  KINH DO
深夜	しんや đêm khuya THÂM DẠ
深刻（な）	しんこく（な） sự nghiêm trọng THÂM KHẮC
座席	ざせき chỗ ngồi TỌA TỊCH
銀行口座	ぎんこうこうざ tài khoản ngân hàng NGÂN HÀNH, HÀNG, HẠNH KHẨU TỌA
座る	すわる ngồi, ngồi xuống TỌA
寄付	きふ quyên góp, tặng cho KÝ PHÓ
取り寄せる	とりよせる mang đến, gửi đến THỦ KÝ
立ち寄る	たちよる tạt qua LẬP KÝ
年寄り	としより người già, người có tuổi NIÊN KÝ
深い	ふかい dày, sâu THÂM
降車口	こうしゃぐち cửa xuống xe GIÁNG, HÀNG XA KHẨU
下降	かこう rơi xuống, tụt xuống HẠ GIÁNG, HÀNG
降りる	おりる xuống 	 xe, núi  GIÁNG, HÀNG
降る	ふる rơi 	mưa , đổ 	mưa GIÁNG, HÀNG
両親	りょうしん cha mẹ, bố mẹ LƯỠNG THÂN
両方	りょうほう hai hướng, hai bên LƯỠNG PHƯƠNG
両～	りょう～ cả hai ~ LƯỠNG
両目	りょうめ đôi mắt ~ LƯỠNG MỤC
両替	りょうがえ đổi tiền LƯỠNG THẾ
着替える	きかえる thay quần áo TRƯỚC THẾ
為替	かわせ ngân phiếu VI, VỊ THẾ
家賃	やちん tiền nhà, tiền thu nhà GIA NHẤN
運賃	うんちん cước vận chuyển VẬN NHẤN
分割	ぶんかつ sự phân cắt, chia PHÂN CÁT
割れる	われる vỡ, bể CÁT
割引	わりびき giảm giá CÁT DẪN
時間割	じかんわり thời gian biểu, thời gian làm việc và nghỉ ngơi THỜI, THÌ GIAN, GIÁN CÁT
増加	ぞうか gia tăng TĂNG GIA
増える	ふえる tăng lên TĂNG
割増	わりまし tiền thưởng, tiền trả thêm CÁT TĂNG
優先	ゆうせん ưu tiên ƯU TIÊN
優しい	やさしい hiền dịu, dịu dàng ƯU
優れる	すぐれる xuất sắc ƯU
席	せき chỗ ngồi TỊCH
出席	しゅっせき có mặt, tham dự XUẤT TỊCH
指定席	していせき ghế chỉ định CHỈ	SÁP, THÁP ĐỊNH TỊCH
側面	そくめん mặt bên, một mặt TRẮC DIỆN
両側	りょうがわ hai bên LƯỠNG TRẮC
～側	～がわ bên, phía bên TRẮC
郵便	ゆうびん dịch vụ bưu điện BƯU TIỆN
郵送	ゆうそう thư từ, thư tín BƯU TỐNG
郵便局	ゆうびんきょく bưu điện BƯU TIỆN CỤC
薬局	やっきょく hiệu thuốc DƯỢC CỤC
放送局	ほうそうきょく đài truyền hình, đài phát thanh PHÓNG TỐNG CỤC
貯金	ちょきん gửi tiền vào ngân hàng TRỮ KIM
包帯	ほうたい băng bó BAO ĐỚI, ĐÁI
包む	つつむ gói vào, bọc vào BAO
小包	こづつみ bưu kiện nhỏ TIỂU BAO
発達	はったつ phát triển PHÁT ĐẠT
速達	そくたつ chuyển phách nhanh TỐC ĐẠT
友達	ともだち bạn bè HỮU ĐẠT
部署	ぶしょ cương vị BỘ THỰ
消防署	しょうぼうしょ cục phòng cháy chữa cháy TIÊU PHÒNG THỰ
税務署	ぜいむしょ phòng thuế THUẾ VỤ THỰ
依頼	いらい sự nhờ vả, yêu cầu Y LẠI
信頼	しんらい tin cậy, tín nhiệm TÍN LẠI
頼む	たのむ nhờ vả LẠI
頼る	たよる phục thuộc LẠI
頼もしい	たのもしい đáng tin LẠI
頼りない	たよりない không đáng tin LẠI
都道府県	とどうふけん sự phân chia hành chính của nhật ĐÔNG ĐẠO PHỦ HUYỆN
京都府	きょうとふ phủ Kyoto, tỉnh Kyoto KINH ĐÔNG PHỦ
到着	とうちゃく đến, đến nơi ĐÁO TRƯỚC
希望	きぼう hy vọng HY VỌNG
失望	しつぼう thất vọng THẤT VỌNG
望遠鏡	ぼうえんきょう kính viễn vọng VỌNG VIỄN KÍNH
望む	のぞむ nguyện vọng, mong ước VỌNG
申請	しんせい thỉnh cầu, yêu cầu THÂN THỈNH
申す	もうす tên là, nói là THÂN
申し込み	もうしこみ sự đề nghị THÂN VÀO
申し上げる	もうしあげる nói, kể, diễn đạt THÂN THƯỢNG
姓	せい họ TÍNH
姓名	せいめい họ và tên TÍNH DANH
年齢	ねんれい tuổi tác NIÊN LINH
高齢	こうれい tuổi cao CAO LINH
男性	だんせい đàn ông NAM TÍNH
女性	じょせい phụ nữ NỮ TÍNH
性別	せいべつ khác biệt giới tính TÍNH BIỆT
性質	せいしつ tính chất TÍNH CHẤT
安全性	あんぜんせい tính an toàn AN, YÊN TÒAN TÍNH
可能性	かのうせい tính khả năng KHẢ NĂNG TÍNH
お宅	おたく nhà 	nói kính trọng TRẠCH
自宅	じたく nhà mình TỰ TRẠCH
住宅	じゅうたく nhà ở, nơi sống TRÚ TRẠCH
帰宅	きたく việc về nhà QUI TRẠCH
勤務	きんむ công việc CẦN VỤ
出勤	しゅっきん đi làm XUẤT CẦN
通勤	つうきん đi làm THÔNG CẦN
勤める	つとめる làm việc CẦN
全部	ぜんぶ toàn bộ TÒAN BỘ
部分	ぶぶん bộ phận BỘ PHÂN
部長	ぶちょう trưởng phòng BỘ TRƯỜNG, TRƯỞNG
学部	がくぶ khoa, ngành học HỌC BỘ
部屋	へや căn phòng BỘ ỐC
結婚	けっこん kết hôn KẾT HÔN
婚約	こんやく đính hôn, đính ước HÔN ƯỚC
未婚	みこん chưa kết hôn VỊ, MÙI HÔN
新婚	しんこん tân hôn, mới kết hôn TÂN HÔN
招待	しょうたい chiêu đãi, mời CHIÊU, TRIỀU ĐÃI
招く	まねく mời, rủ CHIÊU, TRIỀU
～状	～じょう thư ～ TRẠNG
現状	げんじょう hiện trạng, tình hình HIỆN TRẠNG
状態	じょうたい trạng thái TRẠNG THÁI
年賀状	ねんがじょう thiệp chúc tết NIÊN HẠ TRẠNG
欠席	けっせき vắng mặt, không tham dự KHUYẾT TỊCH
出欠	しゅっけつ có mặt hay vắng mặt XUẤT KHUYẾT
欠点	けってん khuyết điểm KHUYẾT ĐiỂM
欠けている点	かけているてん khuyết điểm KHUYẾT ĐiỂM
喜ぶ	よろこぶ vui mừng HỶ
喜んで	よろこんで hân hoan, sẵn lòng HỶ
政治	せいじ chính trị CHÍNH TRỊ
自治会	じちかい hiệp hội tự trị TỰ TRỊ HỘI
自治体	じちたい đoàn thể tự trị TỰ TRỊ THỂ
治す	なおす chữa 	bệnh  TRỊ
委員	いいん ủy viên ỦY VIÊN
委員会	いいんかい ủy, ủy ban ỦY VIÊN HỘI
委任状	いにんじょう giấy ủy nhiệm ỦY NHIỆM TRẠNG
祝日	しゅくじつ ngày lễ CHÚC NHẬT
祝う	いわう chúc, chúc mừng CHÚC
お祝い	おいわい chúc mừng 	quà chúc mừng CHÚC
舞台	ぶたい sân khấu VŨ ĐÀI
舞う	まう nhảy múa VŨ
お見舞い	おみまい thăm người bệnh KIẾN VŨ
お礼	おれい cảm ơn, cảm tạ LỄ
失礼（な）	しつれい（な） thất lễ THẤT LỄ
礼儀	れいぎ lễ nghi LỄ NGHI
多忙	たぼう rất bận, bận rộn ĐA MANG
忙しい	いそがしい bận rộn MANG
夫妻	ふさい vợ chồng PHU THÊ
妻	つま vợ 	tôi  THÊ
主張	しゅちょう chủ trương CHỦ TRƯƠNG
出張	しゅっちょう đi công tác XUẤT TRƯƠNG
頑張る	がんばる cố gắng NGOAN TRƯƠNG
引っ張る	ひっぱる kéo, lôi kéo DẪN TRƯƠNG
張る	はる kéo dài TRƯƠNG
奥様	おくさま vợ 	ngài DẠNG
奥	おく bên trong
浅い	あさい nông cạn, ít THIỂN
浅草	あさくさ khô THIỂN THẢO
浅ましい	あさましい khô, cạn THIỂN
～君	～きみ ～ cậu, bé 	dùng sau tên người con trai  QUÂN
君	きみ em QUÂN
永久	えいきゅう vĩnh cửu VĨNH CỬU
久しぶり	ひさしぶり đã bao lâu nay CỬU
相互	そうご sự qua lại, sự tương hỗ lẫn nhau TƯƠNG, TƯỚNG HỖ
交互	こうご tương tác lẫn nhau GIAO HỖ
お互いに	おたがいに cùng nhau HỖ
追加	ついか thêm vào, thêm TRUY GIA
追う	おう đuổi, đuổi theo TRUY
追い越す	おいこす vượt qua TRUY VIỆT
追い付く	おいつく đuổi kịp TRUY PHÓ
追伸	ついしん tái bút TRUY THÂN
伸びる	のびる lớn lên, kéo dài THÂN
伸ばす	のばす làm thẳng ra THÂN
伸びをする	のびをする vươn vai THÂN
皆	みな tất cả mọi người GIAI
皆さん	みなさん tất cả mọi người GIAI
お歳暮	おせいぼ cuối năm TUẾ MỘ
暮らす	くらす sinh sống MỘ
暮れ	くれ cuối năm MỘ
夕暮れ	ゆうぐれ chiều tối TỊCH MỘ
習慣	しゅうかん tập quán, phong tục TẬP QUÁN
慣れる	なれる quen với, trở nên quen với QUÁN
生活	せいかつ cuộc sống SINH HỌAT
活用	かつよう sự ứng dụng HỌAT DỤNG
活字	かつじ chữ in HỌAT TỰ
活発（な）	かっぱつ（な） linh hoạt, hoạt bát HỌAT PHÁT
恋愛	れんあい tình yêu LUYẾN ÁI
恋	こい tình yêu LUYẾN
恋人	こいびと người yêu LUYẾN NHÂN
恋しい	こいしい được yêu mến, yêu quý LUYẾN
健在	けんざい sức khỏe tốt, khỏe mạnh KIỆN TẠI
健全（な）	けんぜん（な） khỏe mạnh KIỆN TÒAN
健やか	な	すこやか（な） khỏa mạnh, mạnh mẽ KIỆN
健康	けんこう sức khỏe KIỆN KHANG
健康保険証	けんこうほけんしょう bảo hiểm y tế 	bảo hiểm sức khỏe  KIỆN KHANG BẢO HiỂM CHỨNG
祈願	きがん cầu nguyện, cầu khấn KỲ NGUYỆN
祈る	いのる cầu nguyện KỲ
祈り	いのり cầu nguyện KỲ
幸福	こうふく hạnh phúc HẠNH PHÚC
福祉	ふくし phúc lợi PHÚC CHỈ
拝見	はいけん đọc, xem 	thư  BÁI KIẾN
拝借	はいしゃく mượn BÁI TÁ
参拝者	さんぱいしゃ người thăm hỏi TAM, THAM BÁI GIẢ
拝む	おがむ cúi lạy; khấu đầu BÁI
打者	だしゃ người đánh bóng ĐẢ GIẢ
打つ	うつ đánh, vỗ ĐẢ
打ち合わせ	うちあわせ sắp xếp gặp mặt ĐẢ HỢP
伺う	うかがう đến thăm TỨ
幸運（な）	こううん（な） may mắn, vận may HẠNH VẬN
不幸（な）	ふこう（な） không may, bất hạnh BẤT HẠNH
幸せ（な）	しあわせ（な） hạnh phúc HẠNH
幸い	さいわい sự may, gặp may HẠNH
失礼（な）	しつれい（な） thất lễ,vô phép THẤT LỄ
失業	しつぎょう thất nghiệp THẤT NGHIỆP
失望	しつぼう thất vọng THẤT VỌNG
失う	うしなう thất lạc, rớt THẤT
突然	とつぜん đột nhiên, đột ngột ĐỘT NHIÊN
煙突	えんとつ ống khói YÊN ĐỘT
突き当たり	つきあたり cuối 	con phố, ngõ cụt ĐỘT ĐANG, ĐƯƠNG
突っ込む	つっこむ xô đẩy ĐỘT VÀO
全然	ぜんぜん hoàn toàn TÒAN NHIÊN
自然	しぜん tự nhiên TỰ NHIÊN
当然	とうぜん đương nhiên ĐANG, ĐƯƠNG NHIÊN
天然	てんねん thiên nhiên THIÊN NHIÊN
諸～	しょ～ các, nhiều,vài ~ CHƯ
諸問題	しょもんだい các vấn đề CHƯ VẤN ĐỀ
諸般	しょはん nhiều, đa dạng CHƯ BAN
事情	じじょう sự tình, tình hình SỰ TÌNH
友情	ゆうじょう tình bạn HỮU TÌNH
表情	ひょうじょう sự biểu lộ tình cảm BIỂU TÌNH
情け	なさけ cảm thông TÌNH
情けない	なさけない không có sự cảm thông TÌNH
引退	いんたい nghỉ hưu, từ chức DẪN THÓAI
退院	たいいん sự ra viện, xuất viện THÓAI ViỆN
退学	たいがく nghỉ học, bỏ học THÓAI HỌC
退く	しりぞく lui về sau, rút về THÓAI
職業	しょくぎょう nghề nghiệp CHỨC NGHIỆP
職場	しょくば nơi làm việc CHỨC TRƯỜNG, TRÀNG
退職	たいしょく nghỉ việc THÓAI CHỨC
職人	しょくにん người lao động, thợ CHỨC NHÂN
紹介	しょうかい giới thiệu THIỆU GIỚI
介入	かいにゅう can thiệp, xen vào GIỚI NHẬP
介護	かいご chăm sóc người bệnh GIỚI HỘ
一次試験	いちじしけん thi lần đầu NHẤT THỨ THÍ NGHIỆM
次	つぎ lần sau, tiếp đến THỨ
次第	しだい "1. ngay khi2. tùy thuộc " THỨ ĐỆ
文章	ぶんしょう văn chương VĂN CHƯƠNG
章	しょう chương, hồi 	 sách  CHƯƠNG
対する	たいする ngược lại, đối lại ĐỐI
反対	はんたい trái lại, ngược lại PHẢN ĐỐI
～対～	～たい～ đối ĐỐI
対照的（な）	たいしょうてき（な） tính đối chiếu ĐỐI CHIẾU ĐÍCH
対	たい cặp ĐỐI
最初	さいしょ đầu tiên, lần đầu TỐI SƠ
最後	さいご cuối cùng TỐI HẬU
最近	さいきん gần đây, quanh vùng TỐI CÂ?N
最も	もっとも vô cùng, rất TỐI
適当（な）	てきとう（な） tương thích, phù hợp THÍCH ĐANG, ĐƯƠNG
適切（な）	てきせつ（な） thích hợp, thích đáng THÍCH THIẾT
適する	てきする thích hợp THÍCH
適度（な）	てきど（な） mức độ thích hợp THÍCH ĐỘ
誤解	ごかい hiểu lầm, hiểu sai NGỘ	TẠ GIẢI
誤り	あやまり nhầm lẫn, lỗi NGỘ	TẠ
直線	ちょくせん đường thẳng TRỰC TUYẾN
正直（な）	しょうじき（な） chính trực CHÍNH TRỰC
直す	なおす sửa chữa TRỰC
素直（な）	すなお（な） ngoan hiền TỐ TRỰC
直ちに	ただちに ngay lập tức TRỰC
例	れい thí dụ LỆ
例外	れいがい ngoại lệ LỆ NGOẠI
実例	じつれい ví dụ thực tế THỰC LỆ
例えば	たとえば ví dụ LỆ
例える	たとえる so sánh LỆ
名詞	めいし danh từ DANH TỪ
動詞	どうし động từ ĐỘNG TỪ
自動詞	じどうし tự động từ TỰ ĐỘNG TỪ
他動詞	たどうし tha động từ THA ĐỘNG TỪ
形式	けいしき hình thức HÌNH THỨC
形容詞	けいようし tính từ HÌNH DUNG TỪ
図形	ずけい đồ họa ĐỒ HÌNH
人形	にんぎょう búp bê NHÂN HÌNH
形	かたち hình dáng, kiểu HÌNH
救助	きゅうじょ cứu trợ, cứu giúp CỨU TRỢ
助詞	じょし trợ từ TRỢ TỪ
助手	じょしゅ phụ tá TRỢ THỦ
助かる	たすかる được cứu sống TRỢ
助ける	たすける giúp, cứu giúp TRỢ
副詞	ふくし phó từ PHÓ TỪ
副～	ふく～ phó ～ PHÓ
周囲	しゅうい chu vi CHU VI
囲む	かこむ bao quanh, bao vây VI
憎らしい	にくらしい đáng ghét, ghê tởm TĂNG
自殺	じさつ tự sát, tự tử TỰ SÁT, SÁI
殺す	ころす giết SÁT, SÁI
悲観	ひかん bi quan BI QUAN
悲しい	かなしい buồn, buồn bã BI
悲しむ	かなしむ buồn; thương tâm BI
恥	はじ xấu hổ SỈ
恥ずかしい	はずかしい e thẹn, ngượng ngùng SỈ
感じる	かんじる cảm thấy, cảm giác CẢM
感情	かんじょう cảm tình CẢM TÌNH
感心（な）	かんしん（な） khâm phục, ngưỡng mộ CẢM TĂM
感動	かんどう cảm động CẢM ĐỘNG
地球	ちきゅう trái đất ĐỊA CẦU
電球	でんきゅう bóng đèn ĐiỆN CẦU
野球	やきゅう bóng chày DÃ CẦU
球	たま banh, quả bóng CẦU
平和	へいわ hòa bình BÌNH HÒA, HỌA
和式	わしき kiểu nhật HÒA, HỌA THỨC
愛	あい tình yêu ÁI
愛する	あいする yêu mến, yêu quý ÁI
愛情	あいじょう tình yêu ÁI TÌNH
恋愛	れんあい tình yêu LUYẾN ÁI
仲	なか quan hệ TRỌNG
仲間	なかま bạn bè, đồng nghiệp TRỌNG GIAN, GIÁN
改良	かいりょう cải thiện, cải tiến CẢI LƯƠNG
良い	よい tốt LƯƠNG
夢中	むちゅう say sưa, say mê MỘNG TRUNG, TRÚNG
夢	ゆめ giấc mơ MỘNG
専門	せんもん chuyên môn CHUYÊN MÔN
専用	せんよう chuyên dùng CHUYÊN DỤNG
専攻	せんこう chuyên môn,chuyên ngành CHUYÊN CÔNG
歴史	れきし lịch sử LỊCH SỬ
～史	～し lịch sử ～ SỬ
区域	くいき khu vực KHU VỰC
地域	ちいき vùng, vành đai ĐỊA VỰC
祭日	さいじつ ngày lễ TẾ NHẬT
～祭	～さい ～ lễ TẾ
（お）祭り	（お）まつり lễ hội TẾ
検査	けんさ kiểm tra KIỂM TRA
調査	ちょうさ điều tra ĐiỀU, ĐiỆU TRA
審査	しんさ thẩm tra THẨM TRA
～戦	～せん trận～ CHIẾN
大戦	たいせん đại chiến ĐẠI CHIẾN
戦争	せんそう chiến tranh CHIẾN TRANH
戦う	たたかう chiến đấu CHIẾN
競争	きょうそう cạnh tranh CẠNH TRANH
争う	あらそう cạnh tranh TRANH
将来	しょうらい tương lai TƯƠNG. TƯỚNG LAI
将棋	しょうぎ cờ tướng TƯƠNG. TƯỚNG KỲ
歩道橋	ほどうきょう cầu vượt, cầu cho người đi bộ BỘ ĐẠO KIỀU
鉄橋	てっきょう cầu sắt THIẾT KIỀU
橋	はし cầu KIỀU
架け橋	かけはし "1. xây cầu; bắc cầu/2. liên kết chéo; liên quan chéo" GIÁ KIỀU
憎い	にくい đáng ghét TĂNG
憎む	にくむ ghét, ghê tởm TĂNG
憎しみ	にくしみ sự ghét, sự căm hờn TĂNG
腹	はら bụng PHÚC
腹痛	ふくつう đau bụng PHÚC THỐNG
背	せ lưng BÔ?I, BỘI
息	いき hơi thở TỨC
背中	せなか sau lưng BÔ?I, BỘI TRUNG, TRÚNG
休息	きゅうそく nghỉ giải lao; nghỉ ngơi HƯU TỨC
息子	むすこ con trai TỨC TỬ, TÝ
血	ち máu HUYẾT
高血圧	こうけつあつ cao huyết áp CAO HUYẾT ÁP
圧力	あつりょく áp lực; sức ép ÁP LỰC
心臓	しんぞう tâm; tim TĂM TẠNG
内臓	ないぞう nội tạng; lòng NỘI TẠNG
血液	けつえき máu HUYẾT DỊCH
鼻	はな mũi TỴ
鼻水	はなみず nước mũi TỴ THỦY
耳鼻科	じびか khoa tai mũi NHĨ TỴ KHOA
吸う	すう hít; hút; bú HẤP
吸収	きゅうしゅう hấp thụ; hấp thu HẤP THU
呼吸	こきゅう hô hấp; thở HÔ HẤP
眠い	ねむい buồn ngủ MIÊN
眠る	ねむる ngủ MIÊN
居眠りする	いねむりする ngủ gật CƯ MIÊN
睡眠	すいみん việc ngủ; giấc ngủ THỤY MIÊN
欲しい	ほしい muốn; mong muốn DỤC
欲張り	よくばり tham lam; hám lợi DỤC TRƯƠNG
食欲	しょくよく ngon miệng; thèm ăn THỰC DỤC
疲れる	つかれる 1. mệt mỏi 2. cũ rồi BÌ
胃	い dạ dày; bao tử VỊ
胃腸	いちょう dạ dày và ruột VỊ TRƯỜNG
胃腸薬	いちょうやく thuốc đau bao tử VỊ TRƯỜNG DƯỢC
胸	むね ngực HUNG
傾向	けいこう khuynh hướng, xu hướng KHUYNH HƯỚNG
傾く	かたむく nghiêng về KHUYNH
傾ける	かたむける khiến cho có khuynh hướng KHUYNH
横転	おうてん lật ngửa HOẠNH, HOÀNH CHUYỂN
横断歩道	おうだんほどう đường đi bộ, đường đi bộ cho người sang đường HOẠNH, HOÀNH ĐÓAN BỘ ĐẠO
横	よこ bên cạnh HOẠNH, HOÀNH
熱湯	ねっとう nước sôi NHIỆT THANG
湯	ゆ nước sôi THANG
湯飲み	ゆのみ chén trà THANG Ẩm
湯気	ゆげ hơi nức THANG KHÍ
恐怖	きょうふ sợ hãi KHỦNG BỐ
恐ろしい	おそろしい đáng sợ KHỦNG
恐れ	おそれ lo sợ, sợ hãi KHỦNG
恐れ入ります	おそれいります xin lỗi KHỦNG NHẬP
原料	げんりょう nguyện liệu NGUYÊN LIỆU
原産	げんさん xuất xứ NGUYÊN SẢN
野原	のはら cánh đồng DÃ NGUYÊN
原因	げんいん nguyên nhân NGUYÊN NHÂN
要因	よういん nguyên nhân chính YÊU, YẾU NHÂN
位置	いち vị trí VỊ TRÍ
装置	そうち trang thiết bị TRANG TRÍ
置く	おく đặt, để TRÍ
物置	ものおき kho cất đồ, phòng để đồ VẬT TRÍ
寝室	しんしつ phòng ngủ TẨM THẤT
寝坊	ねぼう ngủ dậy muộn TẨM PHƯỜNG
寝る	ねる ngủ TẨM
昼寝	ひるね ngủ trưa, nghỉ trưa TRÚ TẨM
熱	ねつ phát sốt NHIỆT
熱心（な）	ねっしん（な） nhiệt tình NHIỆT TĂM
熱中	ねっちゅう nhiệt tình NHIỆT TRUNG, TRÚNG
熱い	あつい nóng, nóng bỏng NHIỆT
燃焼	ねんしょう đốt cháy NHIÊN THIÊU
焼く	やく nướng, rán THIÊU
焼ける	やける nướng, rán THIÊU
接触	せっしょく tiếp xúc TIẾP XÚC
感触	かんしょく cảm xúc CẢM XÚC
触れる	ふれる chạm, tiếp xúc XÚC
触る	さわる sờ, mó XÚC
灯油	とうゆ dầu hỏa, dầu đèn ĐĂNG DU
灯台	とうだい hải đăng ĐĂNG ĐÀI
蛍光灯	けいこうとう đèn nê	ông HÙYNH, OANH QUANG ĐĂNG
電灯	でんとう đèn điện ĐiỆN ĐĂNG
石油	せきゆ dầu, dầu lửa THẠCH DU
原油	げんゆ dầu thô NGUYÊN DU
油断	ゆだん sự cẩu thả DU ĐÓAN
油	あぶら mỡ DU
余分（な）	よぶん（な） thừa DƯ PHÂN
余計（な）	よけい（な） dư thừa, thừa thãi DƯ KẾ
余裕	よゆう phần dư DƯ DỤ
余る	あまる dư thừa, bị bỏ lại DƯ
羊毛	ようもう lông cừu DƯƠNG MAO
毛	け lông, tóc MAO
毛布	もうふ chăn, mền MAO BỐ
糸	いと chỉ, sợi chỉ MỊCH
毛糸	けいと len, sợi len MAO MỊCH
肌	はだ da CƠ
肌着	はだぎ quần áo lót CƠ TRƯỚC
柔軟（な）	じゅうなん（な） mềm dẻo, linh hoạt NHU NHUYỄN
柔道	じゅうどう võ judo NHU ĐẠO
柔らかい	やわらかい mềm mại NHU
香水	こうすい nước hoa HƯƠNG THỦY
無香料	むこうりょう hàng dởm, không phải hàng hiệu VÔ HƯƠNG LIỆU
香辛料	こうしんりょう gia vị HƯƠNG TÂN LIỆU
香り	かおり hương thơm, mùi thơm HƯƠNG
軟弱（な）	なんじゃく（な） mềm yếu NHUYỄN NHƯỢC
柔軟体操	じゅうなんたいそう tập thể dục NHU NHUYỄN THỂ THÁO, THAO
軟らかい	やわらかい mềm, xốp NHUYỄN
溶岩	ようがん dung nham DUNG NHAM
溶ける	とける chảy ra 	kim loại, tan ra 	băng, tuyết DUNG
溶かす	とかす làm nóng chảy bằng nhiệt DUNG
洗濯	せんたく giặt giũ TiỂN TRẠC
洗濯機	せんたくき máy giặt TiỂN TRẠC CƠ
直接	ちょくせつ trực tiếp TRỰC TIẾP
間接	かんせつ gián tiếp GIAN, GIÁN TIẾP
面接	めんせつ phỏng vấn DIỆN TIẾP
接近	せっきん sự tiếp cận TIẾP CÂ?N
塗る	ぬる thoa, bôi, xoa ĐỒ
一緒	いっしょ cùng nhau NHẤT TỰ
泥	どろ bùn NÊ
泥棒	どろぼう kẻ trộm NÊ BỔNG
卵黄	らんおう lòng đỏ trứng NÕAN HÒANG
黄身	きみ lòng đỏ HÒANG THÂN
黄色	きいろ màu vàng HÒANG SẮC
用途	ようと ứng dựng DỤNG ĐỒ
途中	とちゅう giữa đường ĐỒ TRUNG, TRÚNG
中途	ちゅうと giữa chừng TRUNG, TRÚNG ĐỒ
途端	とたん ngay khi, vừa lúc ĐỒ ĐOAN
道具	どうぐ dụng cụ ĐẠO CỤ
具合	ぐあい trạng thái, tình trạng CỤ HỢP
家具	かぐ đồ đạc gia đình, dụng cụ gia đình GIA CỤ
雨具	あまぐ đồ đi mưa VŨ CỤ
起床	きしょう thức dậy KHỞI, KHỈ SÀNG
床	ゆか sàn nhà SÀNG
床屋	とこや hiệu hớt tóc SÀNG ỐC
床の間	とこのま tủ tường SÀNG GIAN, GIÁN
壁	かべ tường, bức tường BÍCH
乾電池	かんでんち ắc quy khô, pin khô CAN ĐiỆN TRÌ
乾く	かわく khô CAN
乾かす	かわかす phơi khô, hong khô CAN
毛布	もうふ chăn, mền MAO BỐ
分布	ぶんぷ phân bố PHÂN BỐ
座布団	ざぶとん đệm, đệm ngồi TỌA BỐ ĐÒAN
布	ぬの vải, vải vóc BỐ
電柱	でんちゅう cột điện ĐiỆN TRỤ
柱	はしら cột, trụ TRỤ
防虫剤	ぼうちゅうざい thuốc trừ sâu PHÒNG TRÙNG TỄ
殺虫剤	さっちゅうざい thuốc trừ sâu SÁT, SÁI TRÙNG TỄ
虫	むし côn trùng TRÙNG
虫歯	むしば răng sâu, sâu răng TRÙNG XỈ
歯科	しか khoa răng, nha khoa XỈ KHOA
歯周病	ししゅうびょう bệnh nha chu XỈ CHU BỆNH
歯医者	はいしゃ bác sĩ nha khoa, nha sĩ XỈ Y GIẢ
歯車	はぐるま bánh răng XỈ XA
典型的（な）	てんけいてき（な） mang tính điển hình ĐiỂN HÌNH ĐÍCH
大型	おおがた loại lớn, cỡ lớn ĐẠI HÌNH
～型	～がた ~ hình HÌNH
欧米	おうべい âu mỹ ÂU MỄ
欧州	おうしゅう châu âu ÂU CHÂU
苦労	くろう gian khổ, vất vả KHỔ LAO
ご苦労様	ごくろうさま cám ơn rất nhiều về... 	cấp dưới nói với cấp trên KHỔ LAO DẠNG
厚生労働者	こうせいろうどうしゃ phúc lợi công nhân HẬU SINH LAO ĐỘNG GIẢ
兆	ちょう nghìn tỷ TRIỆU
貿易	ぼうえき thương mại MẬU DỊ, DỊCH
容易	ようい đơn giản, dễ dàng DUNG DỊ, DỊCH
安易（な）	あんい（な） đơn giản, dễ dàng AN, YÊN DỊ, DỊCH
易しい	やさしい đơn giản DỊ, DỊCH
農業	のうぎょう nông nghiệp NÔNG NGHIỆP
農家	のうか nông dân NÔNG GIA
農産物	のうさんぶつ hàng nông sản NÔNG SẢN VẬT
命じる	めいじる ra lệnh, mệnh lệnh MẠNG, MỆNH
生命	せいめい tính mạng SINH MẠNG, MỆNH
一生懸命	いっしょうけんめい chăm chỉ NHẤT SINH HUYỀN MẠNG, MỆNH
命	いのち sinh mạng, sự sống MẠNG, MỆNH
命令	めいれい mệnh lệnh, ra lệnh MẠNG, MỆNH LỆNH
被害	ひがい thiệt hại BỊ HẠI
被害者	ひがいしゃ người bị hại BỊ HẠI GIẢ
被告	ひこく bị cáo BỊ CÁO
害	がい hại, cái hại HẠI
公害	こうがい ô nhiễn do công nghiệp, ô nhiễm phương tiện giao thông CÔNG HẠI
水害	すいがい nạn lụt THỦY HẠI
殺害	さつがい sát hại SÁT, SÁI HẠI
権利	けんり quyền lợi QUYỀN LỢI
人権	じんけん nhân quyền NHÂN QUYỀN
～権	～けん ~ quyền QUYỀN
億	おく 100 triệu ỨC
星座	せいざ tinh tú TINH TỌA
星	ほし sao TINH
星印	ほしじるし ngôi sao TINH ẤN
見出し	みだし đầu đề KIẾN XUẤT
肝炎	かんえん viêm gan CAN VIÊM
急増	きゅうぞう gia tăng nhanh chóng; bùng nổ CẤP TĂNG
厚労省	こうろうしょう Bộ Y tế, Lao động và Phúc lợi HẬU LAO TỈNH
売上高	うりあげだか doanh số bán ra MẠI THƯỢNG CAO
自由貿易協定	じゆうぼうえききょうてい Hiệp định tự do thương mai 	Free Trade Agreement TỰ DO MẬU DỊ, DỊCH HIỆP ĐỊNH
合意	ごうい hiệp định; thỏa thuận; sự nhất trí HỢP Ý
武器	ぶき vũ khí VÕ, VŨ KHÍ
武力	ぶりょく vũ lực VÕ, VŨ LỰC
武士	ぶし võ sĩ VÕ, VŨ SĨ
巨大（な）	きょだい（な） to lớn, khổng lồ CỰ ĐẠI
巨額	きょがく khoản tiền lớn CỰ NGẠCH
競争	きょうそう cạnh tranh CẠNH TRANH
競馬	けいば đua ngựa CẠNH MÃ
競う	きそう tranh giành nhau CẠNH
失敗	しっぱい thất bại THẤT BẠI
連敗	れんぱい liên tiếp thất bại LIÊN BẠI
敗れる	やぶれる thua, bị đánh bại BẠI
逆	ぎゃく ngược lại, trái lại NGHỊCH
逆転	ぎゃくてん xoay ngược NGHỊCH CHUYỂN
逆さ	さかさ ngược lại NGHỊCH
逆らう	さからう ngược lại NGHỊCH
優勝	ゆうしょう vô địch, chiến thắng ƯU THẮNG
勝負	しょうぶ sự thắng hay thua THẮNG PHỤ
勝敗	しょうはい thắng bại THẮNG BẠI
勝つ	かつ thắng THẮNG
投手	とうしゅ người phát bóng ĐẦU THỦ
投書	とうしょ gửi bài đăng báo ĐẦU THƯ
投資	とうし đầu tư ĐẦU TƯ
投げる	なげる ném ĐẦU
軍	ぐん quân đội QUÂN
～軍	～ぐん quân ~ QUÂN
軍隊	ぐんたい quân đội QUÂN ĐỘI
兵士	へいし binh sĩ BINH SĨ
～兵	～へい quân ~ BINH
兵隊	へいたい quân sĩ BINH ĐỘI
捜査	そうさ điều tra SƯU TRA
捜す	さがす tìm kiếm SƯU
転倒	てんとう ngã nhào CHUYỂN ĐẢO
面倒	めんどう phiền hà DIỆN ĐẢO
倒れる	たおれる gã, gục ngã ĐẢO
倒す	たおす làm gã, đánh gục ĐẢO
骨折	こっせつ gẫy xương CỐT CHIẾT, TRIẾT
骨	ほね xương CỐT
方針	ほうしん phương châm PHƯƠNG CHÂM
針路	しんろ lộ trình CHÂM LỘ
針	はり kim CHÂM
針金	はりがね dây kim loại CHÂM KIM
叫ぶ	さけぶ kêu lên, hét lên KHIẾU
解禁	かいきん hủy bỏ lệnh cấm GIẢI CẤM
運用	うんよう vận dụng; ứng dụng; điều hành VẬN DỤNG
頭脳	ずのう bộ não ĐẦU NÃO
首脳	しゅのう người lãnh đạo THỦ NÃO
抱く	だく "bế; ôm; ấp
hoài bão"	BÃO
抱く	いだく "ôm; ôm ấp
nắm lấy, ấm ủ"	BÃO
抱える	かかえる "ôm
vướng phải; mắc phải; đối mặt "	BÃO
双方	そうほう hai hướng SONG PHƯƠNG
双子	ふたご anh em sinh đôi SONG TỬ, TÝ
尊重	そんちょう tôn trọng TÔN TRỌNG, TRÙNG
尊敬	そんけい tôn kính, kính trọng TÔN KÍNH
雇用	こよう thuê mướn; tuyển dụng CỐ DỤNG
解雇	かいこ đuổi việc, sa thải GIẢI CỐ
雇う	やとう thuê người làm CỐ
条件	じょうけん điều kiện, điều khoản ĐiỀU KIỆN
条約	じょうやく hiệp ước ĐiỀU ƯỚC
改善	かいぜん cải thiện CẢI THIỆN
善悪	ぜんあく thiện ác THIỆN ÁC
親善	しんぜん thân thiện THÂN THIỆN
法律	ほうりつ pháp luật PHÁP LUẬT
規律	きりつ quy luật QUI LUẬT
情勢	じょうせい tình hình TÌNH THẾ
大勢	おおぜい đại chúng; đám đông; nhiều người ĐẠI THẾ
姿勢	しせい "tư thế
thái độ"	TƯ THẾ
勢い	いきおい quyền lực THẾ
恐怖	きょうふ sợ hãi, lo lắng KHỦNG BỐ
怖い	こわい sợ, đáng sợ BỐ
荒い	あらい khốc liệt HOANG
荒れる	あれる hoang vu HOANG
荒らす	あらす phá hủy HOANG
耕地	こうち đất canh tác, đất nông nghiệp CANH ĐỊA
休耕地	きゅうこうち bỏ hoang đất HƯU CANH ĐỊA
耕す	たがやす cày cấy CANH
風景	ふうけい phong cảnh PHONG CẢNH
光景	こうけい quang cảnh QUANG CẢNH
景気	けいき tình hình kinh tế CẢNH KHÍ
景色	けしき phong cảnh CẢNH SẮC
掘る	ほる đào QUẬT
掘り返す	ほりかえす bới lên QUẬT PHẢN
決行	けっこう hành xử; hành xử QUYẾT HÀNH, HÀNG, HẠNH
スト	スト cuộc đình công
会談	かいだん hội đàm HỘI ĐÀM
変身	へんしん biến dạng; biến hình; biến thái BiẾN THÂN
景観	けいかん cảnh quan CẢNH QUAN
不当	ふとう không hợp lý; không thỏa đáng BẤT ĐANG, ĐƯƠNG
気が荒い	きがあらい nóng tính KHÍ HOANG
寮	りょう ký túc xá LIÊU
批判	ひはん phê phán, phê bình PHÊ PHÁN
批評	ひひょう bình luận PHÊ BÌNH
判断	はんだん phán đoán PHÁN ĐÓAN
評判	ひょうばん bình luận BÌNH PHÁN
裁判	さいばん xét xử TÀI PHÁN
大臣	だいじん bộ trưởng ĐẠI THẦN
総理大臣	そうりだいじん thủ tướng TỔNG LÝ ĐẠI THẦN
外務大臣	がいむだいじん bộ trượng ngoại giao NGOẠI VỤ ĐẠI THẦN
賢明（な）	けんめい（な） thông minh HIỀN MINH
賢い	かしこい thông minh HIỀN
勇気	ゆうき dũng cảm DŨNG KHÍ
勇ましい	いさましい dũng cảm DŨNG
敬意	けいい tôn kính KÍNH Ý
敬語	けいご kính ngữ KÍNH NGỮ
敬う	うやまう kính trọng KÍNH
評価	ひょうか đánh giá BÌNH GIÁ
評論	ひょうろん bình luận BÌNH LuẬN
似る	にる giống TỰ
似合う	にあう hợp TỰ HỢP
似顔絵	にがおえ tranh chân dung TỰ NHAN HỘI
犯人	はんにん phạm nhân PHẠM NHÂN
犯罪	はんざい tội phạm PHẠM TỘI
犯す	おかす vi phạm PHẠM
子孫	しそん con cháu TỬ, TÝ TÔN
孫	まご cháu TÔN
娘	むすめ con gái 	 mình NƯƠNG
孫娘	まごむすめ cháu gái TÔN NƯƠNG
感覚	かんかく cảm giác CẢM GIÁC
覚える	おぼえる nhớ GIÁC
覚ます	さます đánh thức dậy GIÁC
目覚まし時計	めざましどけい đồng hồ báo thức MỤC GIÁC THỜI, THÌ KẾ
覚める	さめる tỉnh dậy, tỉnh giấc GIÁC
帽子	ぼうし nón, mũ MẠO TỬ, TÝ
判定	はんてい phán đoán; phân định PHÁN ĐỊNH
環境	かんきょう môi trường HÒAN CẢNH
環状線	かんじょうせん đường vòng tròn HÒAN TRẠNG TUYẾN
境界	きょうかい biên giới CẢNH GIỚI
国境	こっきょう biên giới quốc gia QUỐC CẢNH
境	さかい biên giới CẢNH
県境	けんきょう ranh giới quận HUYỆN CẢNH
削減	さくげん cắt giảm TƯỚC GIẢM
増減	ぞうげん tăng giảm TĂNG GIẢM
加減	かげん giảm nhẹ GIA GIẢM
減る	へる giảm GIẢM
減らす	へらす làm giảm GIẢM
努力	どりょく nỗ lực NỖ LỰC
努める	つとめる cố gắng NỖ
～庁	～ちょう cơ quan SẢNH
県庁	けんちょう ủy ban tỉnh HUYỆN SẢNH
社会保険庁	しゃかいほけんちょう cơ quan bảo hiểm xã hội XÃ HỘI BẢO HiỂM SẢNH
長官	ちょうかん thư ký TRƯỜNG, TRƯỞNG QUAN
警官	けいかん cảnh sát CẢNH QUAN
宇宙	うちゅう vũ trụ VŨ TRỤ
独自	どくじ cá nhân ĐỘC TỰ
独身	どくしん độc thân ĐỘC THÂN
日独	にちどく nhật	đức NHẬT ĐỘC
独り言	ひとりごと việc nói một mính ĐỘC NGÔN
技術	ぎじゅつ kỹ thuật KỸ THUẬT
技師	ぎし kỹ sư KỸ SƯ
競技	きょうぎ thi đấu CẠNH KỸ
演技	えんぎ kỹ thuật trình diễn DIỄN KỸ
技	わざ kỹ thuật KỸ
財政	ざいせい tài chính TÀI CHÍNH
政治	せいじ chính trị CHÍNH TRỊ
政党	せいとう chính đảng CHÍNH ĐẢNG
政府	せいふ chính phủ CHÍNH PHỦ
状況	じょうきょう tình hình TRẠNG HUỐNG
不況	ふきょう suy thoái kinh tế BẤT HUỐNG
腕力	わんりょく lực cánh tay, bắp thịt UYỂN LỰC
腕	うで cánh tay UYỂN
腕前	うでまえ khéo tay UYỂN TIỀN
上昇	じょうしょう tăng cao, lên cao THƯỢNG THĂNG
昇る	のぼる tăng lên THĂNG
幅	はば chiều rộng BỨC
大幅	おおはば phạm vi rộng, lớn ĐẠI BỨC
著者	ちょしゃ tác giả, nhà văn TRƯỚC, TRỨ GIẢ
著す	あらわす viết TRƯỚC, TRỨ
著しい	いちじるしい đáng kể TRƯỚC, TRỨ
占める	しめる chiếm CHIẾM, CHIÊM
占う	うらなう dự đoán, bói CHIẾM, CHIÊM
比較	ひかく so sánh TỶ GIẢO
比べる	くらべる so với, so sánh TỶ
比較的	ひかくてき có tính so sánh TỶ GIẢO ĐÍCH
平年並み	へいねんなみ như mọi năm BÌNH NIÊN BÍNH
並木	なみき hàng cây BÍNH MỘC
並ぶ	ならぶ được xếp BÍNH
並べる	ならべる sắp, bày BÍNH
しぶとい	しぶとい	Gồng mình; gồng người lên; lấy hết sức
あくどい	あくどい	Màu sắc choe choét; lòe loẹt ;khéo quá mức; quá quắt
きもい	きもい	Ghê; ghê tởm
だる い	だる い	Mỏi; mệt mỏi
くすぐったい	くすぐったい	Lôi thôi; luộm thuộm ;Ngứa ngáy; ngứa
脆い	もろい	Giòn; dễ gãy; dễ đổ vỡ
涙もろ い	なみだもろ い	Dễ xúc động; dễ rơi lệ	LỤY, LỆ
貴い、尊い	とうとい、とうとい	Quí; quí hiếm; đắt giá	QUÝ TÔN
粗い	あらい	Hành động thô thiển; cục mịch ;Vải thô; nhám; ráp; chất xơ	THÔ
荒い、荒っぽい	あらい、あらっぽい	Hung tợn; sóng dữ dội ;Hành động thô thiển; thô bạo	HOANG HOANG
酸い、酸っぱい	すい、すっぱい	Chua	TÁN TÁN
淡い	あわい	Phù du; thoáng qua ;Cảnh sắc mờ nhạt; lạt; nhợt	ĐẠM
潔い	いさぎよい	Trong sạch; tinh khiết; trong sáng	KHIẾT
醜い	みにくい	Xấu xí; khó nhìn	XÚ
情けない	なさけない	Xót; thông cảm ;Từ bi; tử tế	TÌNH
平たい	ひらたい	Bằng phẳng; phẳng ;Nói ̣bình dị; bình dân	BÌNH
切な い	せつな い	Đau buồn; đau khổ; đau đớn	THIẾT
素早い	すばやい	Thoăn thoắt; nhanh nhẹn	TỐ TẢO
煙い、煙たい	けむい、けむたい	Khó thở vì khói; nghẹt thở ;Khói mù mịt	YÊN YÊN
儚い	はかない	Mơ hồ; chẳng ra hồn ;Vô ích; ngu ngốc; không đâu vào đâu（愚か・無益） ;	Cuộc đời ngắn ngủi; nhất thời ;Dễ vỡ; dễ tan vỡ; hèn mọn; nhỏ mọn（みずぼらしい）
欲深 い	よくぶか い	Tham lam; ham muốn nhiều thứ; tham vọng	DỤC THÂM
生臭 い	なまぐさ い	Tanh; ôi tanh ;Tham vọng; đầy tính toán; mưu tính ;Kì quái; kì lạ; quái đản（怪しげな）	SINH XÚ
生温い	なまぬるい		Nước nguội; nhiệt độ giảm ;Mập mờ; không rõ ràng ;Buông lỏng; lỏng lẻo; 	xử lí chưa chặt chẽ	SINH ÔN
快い	こころよい	Sảng khoái; vui vẻ; tươi tắn	KHÓAI
心強い	こころづよい	Mạnh mẽ; cứng cỏi; có nghị lực	TĂM CƯỜNG, CƯỠNG	MIỄN
心細い	こころぼそい	Trơ trọi; bơ vơ; không nơi nương tựa ;Làm ngã lòng; làm nản lòng	TĂM TẾ
疎かな、疎い	おろそかな、うとい	Học qua loa; mau chóng ;Làm qua quít; sơ sơ ;Sơ sài; làm sơ qua	SƠ SƠ
名高い	なだかい	Nổi tiếng; nổi danh	DANH CAO
安っぽい	やすっぽい	Trông rẻ rúm; trông không đẹp ;Suy nghĩ rẻ rúm; nông cạn	AN, YÊN
決まり悪い	きまりわるい	Xấu hổ; hổ thẹn ;Luộm thuộm; lôi thôi	QUYẾT ÁC
容易い	たやすい	Dễ; dễ dàng; dễ làm ;Cẩu thả; sơ ý	DUNG DỊ, DỊCH
穏やかな	おだやか	Êm ả ;êm đềm	ỔN
朗らかな	ほがらか	Tươi tắn ;vui vẻ ;khỏe khoắn 	tính cách ;tươi mát ;trong sáng 	cảm giác  ;yên bình;yên tĩnh	LÃNG
なだらかな	なだらかな	Thoai thoải 	dốc ;đường đi  ;lưu loát ;trôi chảy 	nói
爽やかな	さわやか	Tỉnh táo ;mát mẻ ;sảng khoái 	cảm giác  ;trong trẻo ;lưu loát 	nói
厄介な	やっかい	Phiền muộn	ÁCH GIỚI
惨めな	みじ め	Thảm thiết ;thê thảm	THẢM
哀れな	あわれ	Đáng thương	AI
我がまま	わがま ま	Bướng bỉnh ;ngoan cố	NGÃ
厳かな	おごそかな	Uy nghi; uy nghiêm; trang nghiêm	NGHIÊM
花やかな	はなやかな	Rực rỡ; tráng lệ; tưng bừng	HOA
健やかな	すこやかな	Khỏe khoắn	KIỆN
和やかな	なごやかな	Êm ả; thanh tĩnh; yên bình; êm dịu	HÒA, HỌA
にこやかな	にこやかな	Iềm đạm; ôn hòa; hòa nhã
明るい、明らかな	あかるい、あきらかな	Sáng sủa; minh bạch; rõ ràng	MINH MINH
鮮やかな	あざやかな	Tươi tắn; tươi; chói lọi ;Sặc sỡ; lộng lẫy	TIÊN
粋な	いきな	Diễm lệ; tráng lệ ;Diện; bảnh bao	TÚY
妙な	みょうな	Kì cục; lạ lùng; lạ ;Kì diệu; kì lạ	DIỆU
清らか な	きよらか な	Nước trong sạch; tinh khiết ;Tình yêu trong sáng	THANH
遥か な	はるか な	Xa xôi; xa vời; khoảng cách lớn
秘かな、密かな	ひそかな、みつかな	Lén lút; giấu giếm ;Bước nhẹ nhàng; rón rén	BÍ MẬT
盛んな	さかんな	Thịnh hành; phát triển rộng ;Lan rộng; tràn lan	THỊNH
緩やかな	ゆるやかな	Giảm nhẹ; bớt căng thẳng; giảm bớt mức độ	HÕAN
愚かな	おろかな	Ngu ngốc; đần độn; dại dột	NGU, NGỘ
微かな、幽かな	かすかな、かすかな	Mờ nhạt; thoáng qua; thoang thoảng	VI U
巧みな	たくみな	Khéo léo ;Tinh xảo; tinh vi	XẢO
滑らか な	なめらか な	Trơn; trượt ;Giải quyết trôi chảy; trơn tru	HỌAT
品やか な	しなやか な	Dẻo; dễ uốn nắn ;Mảnh khảnh; nhỏ nhắn	PHẨM
淑やか な	しとやか な	Điềm đạm; nhã nhặn; thanh cao	THỤC
煌びやかな	きらびやかな	Lộng lẫy; lấp lánh; óng ánh ;Nói dứt khoát; dứt khoát
僅か な	わずか な	Hiếm; ít; lượng nhỏ
疑わしい	うたがわしい	Đáng nghi; hồ nghi	NGHI
煩わしい	わずらわしい	Phiền muộn; buồn phiền; lo lắng	PHIỀN
紛らわしい	まぎらわしい		Màu sắc nhang nhác ;	 từ ngữ trông giống nhau khó phân biệt ;Chói chang; chói mắt	PHÂN
悔しい	くやしい	Hậm hực; tức	HỐI
恨めしい	うらめしい	Căm hờn; thù hằn; căm ghét	HẬN
懐かしい	なつかしい	Tiếc nhớ; nhớ	HÒAI
嘆かわし い	たんかわし い	Đau buồn; thương tiếc; đau xót	THAN, THÁN
狂おしい	くるおしい	Điên cuồng	CUỒNG
貧しい	まずしい	Nghèo nàn; bần cùng	BẦN
乏しい	とぼしい	Thiếu thốn; ít; thiếu hụt	PHẠP
甚だしい	はなはだしい	Vô cùng ;rất; lắm 	dùng như một phó từ	THẬM
悩ましい	なやましい	Lo lắng; dằn vặt; bồn chồn	NÃO
卑しい	いやしい	Đê tiện; hạ cấp	TY
慎ましい	つつましい	Thận trọng; cẩn thận ;Nhún ngường; nhũn nhặn	THẬN
久し い	ひさしし い	Lâu; hồi lâu	CỬU
虚しい、空しい	むなしい、むなしい	Không hiệu quả; vô tác dụng; không có nội dung	HƯ KHÔNG
見苦しい	みぐるしい	Hèn; dơ; xấu xí; đáng hổ thẹn	KIẾN KHỔ
相応しい	ふさわしい	Phù hợp; thích hợp	TƯƠNG, TƯỚNG ỨNG
逞し い	ていし い	Tráng kiện; cường tráng
芳しい	かんばしい	Thơm nức; thơm ngào ngạt ;Thơm tho; tốt đẹp（ nghĩa bóng）	PHƯƠNG
麗しい	うるわしい	Lộng lẫy; diễm lệ; rực rỡ	LỆ
華麗な	かれいな	Hùng vĩ; hoành tráng ;Chỉn chu; gọn gàng ;Đúng đắn; chính xác（正しい）	HOA LỆ
恭しい	うやうやしい	Kính cẩn; lễ phép	CUNG
浅ましい	あさましい	Thê thảm; tồi tệ; thảm hại（嘆かわしい） ;đáng xấu hổ; đáng ngượng; đáng hổ thẹn ;Cực kì; rất; ghê gớm（甚だしい） ;hèn hạ; bủn xỉn; hà tiện	THIỂN
夥しい	おびただしい	Rất nhiều; cực nhiều; số lượng và mức độ lớn
みすぼらしい	みすぼらしい	Hèn hạ; đê tiện; hèn mọn
好ましい	このましい	Đáng yêu	HẢO, HIẾU
目覚し い	めざまし い	Tròn xoe mắt; trợn tròn mắt ;Đáng ngạc nhiên; đáng kinh ngạc	MỤC GIÁC
馴れ馴れしい	なれなれしい	Suồng sã; thân mật
汚らわしい	けがらわしい	Bẩn thỉu; dơ dáy ;Dơ bẩn; 	câu chuyện không đáng nghe; ghê	Ô
望まし い	ぼうまし い	Khao khát; mong ước	VỌNG
待ち遠しい	まちどおしい		Đợi chờ nôn nóng; 	chờ đợi mỏi mòn; trông chờ	ĐÃI VIỄN
うっとうしい	うっとうしい	U sầu; u ám; sầu muộn ;Lôi thôi; phiền hà; phiền phức
惜しい	おしい	Không nỡ;không đành;tiếc.	TÍCH
怪しい	あやしい	Kì lạ;kì quái	QUÁI
嬉しい	うれしい	Vui mừng
可笑しい	おかし い	Lạ lùng ;không bình thường	KHẢ TIẾU
悲しい	かなしい	Buồn rầu	BI
厳しい	きびしい	Nghiêm khắc	NGHIÊM
苦 しい	くるしい	Đau khổ ;khổ sở	KHỔ
詳しい	くわしい	Chi tiết	TƯỜNG
険しい	けわし い	Nguy hiểm	HIỂM
恋しい	こいしい	Yêu thương	LUYẾN
寂しい	さびしい	Buồn bã 	khung cảnh buồn bã	TỊCH
親しい	したしい	Thân thiện	THÂN
涼しい	すずし い	Mát mẻ 	khí hậu	LƯƠNG
正しい	ただしい	Phải ;đúng	CHÍNH
楽しい	たのし い	Vui vẻ;vui nhộn 	khung cảnh vui nhộn	NHẠC, LẠC
激しい	はげしい	Mạnh bạo ;dữ dội	KÍCH, KHÍCH
等しい	ひとしい	Công bằng ;bằng nhau	ĐẲNG
貧しい	まずし い	Nghèo đói ;khó khăn	BẦN
眩しい	まぶしい	Chói mắt 	ánh sáng
優 しい	やさしい	Hiền từ 	tính cách	ƯU
易しい	やさしい	Dễ dàng	DỊ, DỊCH
新しい	あたらしい	Mới	TÂN
勇ましい	いさましい	Dũng mãnh;dũng cảm	DŨNG
忙 しい	いそがしい	Bận rộn	MANG
恐ろしい	おそろしい	Đáng sợ;khiếp sợ	KHỦNG
大人しい	おとなしい	Chăm chỉ ;đàng hoàng 	như người lớn	ĐẠI NHÂN
騒がしい	さわがし い	Làm ầm ĩ;gây ồn ào	TAO
頼もしい	たのもしい	Đáng tin cậy	LẠI
懐かしい	なつかしい	Tiếc nhớ;nuối tiếc	HÒAI
恥ずかしい	はずかしい	Xấu hổ	SỈ
難しい	む ずかしい	Khó	NẠN
珍しい	めずらしい	Kì lạ;hiếm có	TRÂN
喧しい	やかましい	Náo động;gây mất trật tự
厚かましい	あつかましい	Trơ trẽn 	mặt dày	HẬU
慌 しい	あわただしい	Vội vàng;hấp tấp	HỎANG
羨ましい	うらやましい	Ghen tị;thèm muốn được như thế
可愛らしい	かわいらしい	Dễ thương; đáng yêu	KHẢ ÁI
憎らしい	にくらし い	Dễ ghét; đáng ghét	TĂNG
図々しい	ずうずうしい	Làm ngơ; thản nhiên; coi như không có chuyện gì	ĐỒ
騒々しい	そうぞうしい	Ầm ĩ;huyên náo	TAO
そ そっかしい	そ そっかしい	Hậu đậu; bất cẩn ;cẩu thả ;sơ ý
馬鹿らしい	ばからしい	Dại dột ;ngốc nghếch ;vô ích; vô tác dụng	MÃ
若々しい	わかわかしい	Trẻ trung	NHƯỢC
濃い	こい	Đặc 	chất lỏng ;đậm ;thẫm 	 màu sắc ; nồng 	 vị 	NÙNG
薄い	うす い	Mỏng ;loãng 	chất lỏng	BẠC
厚い	あつい	Dày	HẬU
浅い	あさい	Nông ;cạn	THIỂN
深い	ふかい	Sâu	THÂM
暑い	あつい	Nóng 	khí hậu	THỬ
寒い	さむ い	Lạnh 	khí hậu	HÀN
熱い	あつい	Nóng 	nhiệt độ	NHIỆT
緩い	ゆる い	Nguội 	nhiệt độ	HÕAN
荒い	あらい	Hung bạo ;hung tợn 	tính tình ;dữ dội 	con sóng 	HOANG
美味い	うまい	Tốt đẹp ;giỏi	MỸ VỊ
偉い	えらい	Tự hào ;kiêu hãnh	VĨ
遅い	おそい	Chậm ;trễ ;muộn	TRÌ
早い	はやい	Sớm	TẢO
速 い	はやい	Nhanh	TỐC
長い	ながい	Dài 	kích thước ;lâu 	thời gian	TRƯỜNG, TRƯỞNG
短 い	みじかい	Ngắn 	kích thước	ĐỎAN
重い	おもい	Nặng	TRỌNG, TRÙNG
軽い	かる い	Nhẹ	KHINH
硬い、堅い、固い	かたい	Cứng ;rắn	NGẠNH KIÊN CỐ
痒い	かゆい	Ngứa ngáy
辛 い	からい	Cay 	vị	TÂN
塩辛い	しおからい	Mặn 	vị	DIÊM TÂN
苦い	にがい	Đắng 	vị	KHỔ
甘い	あまい	Ngọt	CAM
酸っぱい	すっぱい	Chua 	vị	TÁN
渋い	しぶ い	Chát 	vị ;sưng sỉa; cau có 	thái độ ;	dao cùn	SÁP
鋭い	す るどい	Mạnh ;sắc ;nhọn 	dao kiếm	NHUỆ
きつい	きつい	Chật hẹp; chật 	quần áo ;chật vật; eo hẹp 	kinh tế 
ぬるい	ぬるい	Lỏng lẻo ;lỏng
清い	きよ い	Trong trẻo ;tinh khiết	THANH
臭い	くさい	Hôi thối	XÚ
暗い	くら い	Tối ;âm u	ÁM
煙い	けむい	Khó thở 	do khói 	YÊN
凄い	すごい	Tuyệt vời ; khủng; ghê gớm 	khen ngợi
狭い	せまい	Chật ;hẹp 	diện tích	HIỆP
広い	ひろい	Rộng; rộng rãi 	diện tích	QUẢNG
低い	ひく い	Thấp 	mức độ 	ĐÊ
安い	やすい	Rẻ 	giá cả	AN, YÊN
高い	たか い	Cao 	mức độ  ;đắt 	giá cả	CAO
近い	ちかい	Gần	CÂ?N
遠い	とお い	Xa; xa xôi	VIỄN
強い	つよい	Mạnh ; khỏe	CƯỜNG, CƯỠNG	MIỄN
弱い	よわい	Yếu; yếu ớt	NHƯỢC
諄い	くどい	Bướng bỉnh ;hợm hĩnh
狡い	ずるい	Xảo trá ; gian trá
憎い	にくい	Khó gần ;dễ ghét	TĂNG
鈍い	にぶい	Đần độn ; chậm hiểu	ĐỘN
醜 い	みにくい	Xấu xí ;khó coi	XÚ
辛い	つらい	Chán ;nhàm chán	TÂN
面白い	おもし ろい	Thú vị ; hài hước 	tính cách	DIỆN BẠCH
鈍い	のろい	Bình chân như vại ;chậm chạp	ĐỘN
賢い	かしこい	Thông minh ;linh hoạt; lanh lẹ	HIỀN
酷い	ひど い	Nghiêm trọng ;trầm trọng	KHỐC
太い	ふとい	Béo ;mập	THÁI
細い	ほそ い	Thon thả 	dáng người ;thon dài	TẾ
まずい	まずい	Dở ; không ngon 	vị 
丸い	まるい	Tròn	HÒAN
若い	わかい	Trẻ	NHƯỢC
眠い	ねむい	Buồn ngủ	MIÊN
危 うい	あやうい	Nguy hiểm ;suýt nữa thì....	NGUY
うるさい	うるさい	Ồn ào ;náo động 	âm thanh ;lắm chuyện;hay gây sự 	tính cách
青白い	あおじろい	Xanh nhạt	THANH BẠCH
薄 暗い	うすぐらい	Mờ ảo ;tối âm u	BẠC ÁM
蒸し暑い	むしあつい	Nóng bức ;nóng ẩm	CHƯNG THỬ
物 凄い	ものすごい	Ghê gớm ;khung khiếp 	khen ngợi	VẬT
力強い	ちからづよい	Khỏe ;mạnh	LỰC CƯỜNG, CƯỠNG	MIỄN
面倒くさい	めんどうくさい	Phức tạp; phiền phức; rắc rối	DIỆN ĐẢO
すばしこい・すばしっこい	すばしこい・すばしっこい	Nhanh nhẹn; thoăn thoắt