しぶとい	しぶとい _ Gồng mình; gồng người lên; lấy hết sức
あくどい	あくどい _ Màu sắc choe choét; lòe loẹt ;khéo quá mức; quá quắt
きもい	きもい _ Ghê; ghê tởm
だる い	だる い _ Mỏi; mệt mỏi
くすぐったい	くすぐったい _ Lôi thôi; luộm thuộm ;Ngứa ngáy; ngứa
脆い	もろい _ Giòn; dễ gãy; dễ đổ vỡ
涙もろ い	なみだもろ い _ Dễ xúc động; dễ rơi lệ _ LỤY, LỆ
貴い、尊い	とうとい、とうとい _ Quí; quí hiếm; đắt giá _ QUÝ TÔN
粗い	あらい _ Hành động thô thiển; cục mịch ;Vải thô; nhám; ráp; chất xơ _ THÔ
荒い、荒っぽい	あらい、あらっぽい _ Hung tợn; sóng dữ dội ;Hành động thô thiển; thô bạo _ HOANG HOANG
酸い、酸っぱい	すい、すっぱい _ Chua _ TÁN TÁN
淡い	あわい _ Phù du; thoáng qua ;Cảnh sắc mờ nhạt; lạt; nhợt _ ĐẠM
潔い	いさぎよい _ Trong sạch; tinh khiết; trong sáng _ KHIẾT
醜い	みにくい _ Xấu xí; khó nhìn _ XÚ
情けない	なさけない _ Xót; thông cảm ;Từ bi; tử tế _ TÌNH
平たい	ひらたい _ Bằng phẳng; phẳng ;Nói ̣bình dị; bình dân _ BÌNH
切な い	せつな い _ Đau buồn; đau khổ; đau đớn _ THIẾT
素早い	すばやい _ Thoăn thoắt; nhanh nhẹn _ TỐ TẢO
煙い、煙たい	けむい、けむたい _ Khó thở vì khói; nghẹt thở ;Khói mù mịt _ YÊN YÊN
儚い	はかない _ Mơ hồ; chẳng ra hồn ;Vô ích; ngu ngốc; không đâu vào đâu（愚か・無益） ;(Cuộc đời) ngắn ngủi; nhất thời ;Dễ vỡ; dễ tan vỡ; hèn mọn; nhỏ mọn（みずぼらしい）
欲深 い	よくぶか い _ Tham lam; ham muốn nhiều thứ; tham vọng _ DỤC THÂM
生臭 い	なまぐさ い _ Tanh; ôi tanh ;Tham vọng; đầy tính toán; mưu tính ;Kì quái; kì lạ; quái đản（怪しげな） _ SINH XÚ
生温い	なまぬるい _ (Nước) nguội; nhiệt độ giảm ;Mập mờ; không rõ ràng ;Buông lỏng; lỏng lẻo; (xử lí) chưa chặt chẽ _ SINH ÔN
快い	こころよい _ Sảng khoái; vui vẻ; tươi tắn _ KHÓAI
心強い	こころづよい _ Mạnh mẽ; cứng cỏi; có nghị lực _ TĂM CƯỜNG, CƯỠNG(MIỄN)
心細い	こころぼそい _ Trơ trọi; bơ vơ; không nơi nương tựa ;Làm ngã lòng; làm nản lòng _ TĂM TẾ
疎かな、疎い	おろそかな、うとい _ Học qua loa; mau chóng ;Làm qua quít; sơ sơ ;Sơ sài; làm sơ qua _ SƠ SƠ
名高い	なだかい _ Nổi tiếng; nổi danh _ DANH CAO
安っぽい	やすっぽい _ Trông rẻ rúm; trông không đẹp ;Suy nghĩ rẻ rúm; nông cạn _ AN, YÊN
決まり悪い	きまりわるい _ Xấu hổ; hổ thẹn ;Luộm thuộm; lôi thôi _ QUYẾT ÁC
容易い	たやすい _ Dễ; dễ dàng; dễ làm ;Cẩu thả; sơ ý _ DUNG DỊ, DỊCH
穏やかな	おだやか _ Êm ả ;êm đềm _ ỔN
朗らかな	ほがらか _ Tươi tắn ;vui vẻ ;khỏe khoắn (tính cách) ;tươi mát ;trong sáng (cảm giác ) ;yên bình;yên tĩnh _ LÃNG
なだらかな	なだらかな _ Thoai thoải (dốc ;đường đi ) ;lưu loát ;trôi chảy (nói)
爽やかな	さわやか _ Tỉnh táo ;mát mẻ ;sảng khoái (cảm giác ) ;trong trẻo ;lưu loát (nói)
厄介な	やっかい _ Phiền muộn _ ÁCH GIỚI
惨めな	みじ め _ Thảm thiết ;thê thảm _ THẢM
哀れな	あわれ _ Đáng thương _ AI
我がまま	わがま ま _ Bướng bỉnh ;ngoan cố _ NGÃ
厳かな	おごそかな _ Uy nghi; uy nghiêm; trang nghiêm _ NGHIÊM
花やかな	はなやかな _ Rực rỡ; tráng lệ; tưng bừng _ HOA
健やかな	すこやかな _ Khỏe khoắn _ KIỆN
和やかな	なごやかな _ Êm ả; thanh tĩnh; yên bình; êm dịu _ HÒA, HỌA
にこやかな	にこやかな _ Iềm đạm; ôn hòa; hòa nhã
明るい、明らかな	あかるい、あきらかな _ Sáng sủa; minh bạch; rõ ràng _ MINH MINH
鮮やかな	あざやかな _ Tươi tắn; tươi; chói lọi ;Sặc sỡ; lộng lẫy _ TIÊN
粋な	いきな _ Diễm lệ; tráng lệ ;Diện; bảnh bao _ TÚY
妙な	みょうな _ Kì cục; lạ lùng; lạ ;Kì diệu; kì lạ _ DIỆU
清らか な	きよらか な _ Nước trong sạch; tinh khiết ;Tình yêu trong sáng _ THANH
遥か な	はるか な _ Xa xôi; xa vời; khoảng cách lớn
秘かな、密かな	ひそかな、みつかな _ Lén lút; giấu giếm ;Bước nhẹ nhàng; rón rén _ BÍ MẬT
盛んな	さかんな _ Thịnh hành; phát triển rộng ;Lan rộng; tràn lan _ THỊNH
緩やかな	ゆるやかな _ Giảm nhẹ; bớt căng thẳng; giảm bớt mức độ _ HÕAN
愚かな	おろかな _ Ngu ngốc; đần độn; dại dột _ NGU, NGỘ
微かな、幽かな	かすかな、かすかな _ Mờ nhạt; thoáng qua; thoang thoảng _ VI U
巧みな	たくみな _ Khéo léo ;Tinh xảo; tinh vi _ XẢO
滑らか な	なめらか な _ Trơn; trượt ;Giải quyết trôi chảy; trơn tru _ HỌAT
品やか な	しなやか な _ Dẻo; dễ uốn nắn ;Mảnh khảnh; nhỏ nhắn _ PHẨM
淑やか な	しとやか な _ Điềm đạm; nhã nhặn; thanh cao _ THỤC
煌びやかな	きらびやかな _ Lộng lẫy; lấp lánh; óng ánh ;Nói dứt khoát; dứt khoát
僅か な	わずか な _ Hiếm; ít; lượng nhỏ
疑わしい	うたがわしい _ Đáng nghi; hồ nghi _ NGHI
煩わしい	わずらわしい _ Phiền muộn; buồn phiền; lo lắng _ PHIỀN
紛らわしい	まぎらわしい _ (Màu sắc) nhang nhác ;( từ ngữ) trông giống nhau khó phân biệt ;Chói chang; chói mắt _ PHÂN
悔しい	くやしい _ Hậm hực; tức _ HỐI
恨めしい	うらめしい _ Căm hờn; thù hằn; căm ghét _ HẬN
懐かしい	なつかしい _ Tiếc nhớ; nhớ _ HÒAI
嘆かわし い	たんかわし い _ Đau buồn; thương tiếc; đau xót _ THAN, THÁN
狂おしい	くるおしい _ Điên cuồng _ CUỒNG
貧しい	まずしい _ Nghèo nàn; bần cùng _ BẦN
乏しい	とぼしい _ Thiếu thốn; ít; thiếu hụt _ PHẠP
甚だしい	はなはだしい _ Vô cùng ;rất; lắm (dùng như một phó từ) _ THẬM
悩ましい	なやましい _ Lo lắng; dằn vặt; bồn chồn _ NÃO
卑しい	いやしい _ Đê tiện; hạ cấp _ TY
慎ましい	つつましい _ Thận trọng; cẩn thận ;Nhún ngường; nhũn nhặn _ THẬN
久し い	ひさしし い _ Lâu; hồi lâu _ CỬU
虚しい、空しい	むなしい、むなしい _ Không hiệu quả; vô tác dụng; không có nội dung _ HƯ KHÔNG
見苦しい	みぐるしい _ Hèn; dơ; xấu xí; đáng hổ thẹn _ KIẾN KHỔ
相応しい	ふさわしい _ Phù hợp; thích hợp _ TƯƠNG, TƯỚNG ỨNG
逞し い	ていし い _ Tráng kiện; cường tráng
芳しい	かんばしい _ Thơm nức; thơm ngào ngạt ;Thơm tho; tốt đẹp（ nghĩa bóng） _ PHƯƠNG
麗しい	うるわしい _ Lộng lẫy; diễm lệ; rực rỡ _ LỆ
華麗な	かれいな _ Hùng vĩ; hoành tráng ;Chỉn chu; gọn gàng ;Đúng đắn; chính xác（正しい） _ HOA LỆ
恭しい	うやうやしい _ Kính cẩn; lễ phép _ CUNG
浅ましい	あさましい _ Thê thảm; tồi tệ; thảm hại（嘆かわしい） ;đáng xấu hổ; đáng ngượng; đáng hổ thẹn ;Cực kì; rất; ghê gớm（甚だしい） ;hèn hạ; bủn xỉn; hà tiện _ THIỂN
夥しい	おびただしい _ Rất nhiều; cực nhiều; số lượng và mức độ lớn
みすぼらしい	みすぼらしい _ Hèn hạ; đê tiện; hèn mọn
好ましい	このましい _ Đáng yêu _ HẢO, HIẾU
目覚し い	めざまし い _ Tròn xoe mắt; trợn tròn mắt ;Đáng ngạc nhiên; đáng kinh ngạc _ MỤC GIÁC
馴れ馴れしい	なれなれしい _ Suồng sã; thân mật
汚らわしい	けがらわしい _ Bẩn thỉu; dơ dáy ;Dơ bẩn; (câu chuyện) không đáng nghe; ghê _ Ô
望まし い	ぼうまし い _ Khao khát; mong ước _ VỌNG
待ち遠しい	まちどおしい _ (Đợi chờ) nôn nóng; (chờ đợi) mỏi mòn; trông chờ _ ĐÃI VIỄN
うっとうしい	うっとうしい _ U sầu; u ám; sầu muộn ;Lôi thôi; phiền hà; phiền phức
惜しい	おしい _ Không nỡ;không đành;tiếc. _ TÍCH
怪しい	あやしい _ Kì lạ;kì quái _ QUÁI
嬉しい	うれしい _ Vui mừng
可笑しい	おかし い _ Lạ lùng ;không bình thường _ KHẢ TIẾU
悲しい	かなしい _ Buồn rầu _ BI
厳しい	きびしい _ Nghiêm khắc _ NGHIÊM
苦 しい	くるしい _ Đau khổ ;khổ sở _ KHỔ
詳しい	くわしい _ Chi tiết _ TƯỜNG
険しい	けわし い _ Nguy hiểm _ HIỂM
恋しい	こいしい _ Yêu thương _ LUYẾN
寂しい	さびしい _ Buồn bã (khung cảnh buồn bã) _ TỊCH
親しい	したしい _ Thân thiện _ THÂN
涼しい	すずし い _ Mát mẻ (khí hậu) _ LƯƠNG
正しい	ただしい _ Phải ;đúng _ CHÍNH
楽しい	たのし い _ Vui vẻ;vui nhộn (khung cảnh vui nhộn) _ NHẠC, LẠC
激しい	はげしい _ Mạnh bạo ;dữ dội _ KÍCH, KHÍCH
等しい	ひとしい _ Công bằng ;bằng nhau _ ĐẲNG
貧しい	まずし い _ Nghèo đói ;khó khăn _ BẦN
眩しい	まぶしい _ Chói mắt (ánh sáng)
優 しい	やさしい _ Hiền từ (tính cách) _ ƯU
易しい	やさしい _ Dễ dàng _ DỊ, DỊCH
新しい	あたらしい _ Mới _ TÂN
勇ましい	いさましい _ Dũng mãnh;dũng cảm _ DŨNG
忙 しい	いそがしい _ Bận rộn _ MANG
恐ろしい	おそろしい _ Đáng sợ;khiếp sợ _ KHỦNG
大人しい	おとなしい _ Chăm chỉ ;đàng hoàng (như người lớn) _ ĐẠI NHÂN
騒がしい	さわがし い _ Làm ầm ĩ;gây ồn ào _ TAO
頼もしい	たのもしい _ Đáng tin cậy _ LẠI
懐かしい	なつかしい _ Tiếc nhớ;nuối tiếc _ HÒAI
恥ずかしい	はずかしい _ Xấu hổ _ SỈ
難しい	む ずかしい _ Khó _ NẠN
珍しい	めずらしい _ Kì lạ;hiếm có _ TRÂN
喧しい	やかましい _ Náo động;gây mất trật tự
厚かましい	あつかましい _ Trơ trẽn (mặt dày) _ HẬU
慌 しい	あわただしい _ Vội vàng;hấp tấp _ HỎANG
羨ましい	うらやましい _ Ghen tị;thèm muốn được như thế
可愛らしい	かわいらしい _ Dễ thương; đáng yêu _ KHẢ ÁI
憎らしい	にくらし い _ Dễ ghét; đáng ghét _ TĂNG
図々しい	ずうずうしい _ Làm ngơ; thản nhiên; coi như không có chuyện gì _ ĐỒ
騒々しい	そうぞうしい _ Ầm ĩ;huyên náo _ TAO
そ そっかしい	そ そっかしい _ Hậu đậu; bất cẩn ;cẩu thả ;sơ ý
馬鹿らしい	ばからしい _ Dại dột ;ngốc nghếch ;vô ích; vô tác dụng _ MÃ
若々しい	わかわかしい _ Trẻ trung _ NHƯỢC
濃い	こい _ Đặc (chất lỏng) ;đậm ;thẫm ( màu sắc) ; nồng ( vị ) _ NÙNG
薄い	うす い _ Mỏng ;loãng (chất lỏng) _ BẠC
厚い	あつい _ Dày _ HẬU
浅い	あさい _ Nông ;cạn _ THIỂN
深い	ふかい _ Sâu _ THÂM
暑い	あつい _ Nóng (khí hậu) _ THỬ
寒い	さむ い _ Lạnh (khí hậu) _ HÀN
熱い	あつい _ Nóng (nhiệt độ) _ NHIỆT
緩い	ゆる い _ Nguội (nhiệt độ) _ HÕAN
荒い	あらい _ Hung bạo ;hung tợn (tính tình) ;dữ dội (con sóng ) _ HOANG
美味い	うまい _ Tốt đẹp ;giỏi _ MỸ VỊ
偉い	えらい _ Tự hào ;kiêu hãnh _ VĨ
遅い	おそい _ Chậm ;trễ ;muộn _ TRÌ
早い	はやい _ Sớm _ TẢO
速 い	はやい _ Nhanh _ TỐC
長い	ながい _ Dài (kích thước) ;lâu (thời gian) _ TRƯỜNG, TRƯỞNG
短 い	みじかい _ Ngắn (kích thước) _ ĐỎAN
重い	おもい _ Nặng _ TRỌNG, TRÙNG
軽い	かる い _ Nhẹ _ KHINH
硬い、堅い、固い	かたい _ Cứng ;rắn _ NGẠNH KIÊN CỐ
痒い	かゆい _ Ngứa ngáy
辛 い	からい _ Cay (vị) _ TÂN
塩辛い	しおからい _ Mặn (vị) _ DIÊM TÂN
苦い	にがい _ Đắng (vị) _ KHỔ
甘い	あまい _ Ngọt _ CAM
酸っぱい	すっぱい _ Chua (vị) _ TÁN
渋い	しぶ い _ Chát (vi)̣ ;sưng sỉa; cau có (thái độ) ;(dao) cùn _ SÁP
鋭い	す るどい _ Mạnh ;sắc ;nhọn (dao kiếm) _ NHUỆ
きつい	きつい _ Chật hẹp; chật (quần áo) ;chật vật; eo hẹp (kinh tế )
ぬるい	ぬるい _ Lỏng lẻo ;lỏng
清い	きよ い _ Trong trẻo ;tinh khiết _ THANH
臭い	くさい _ Hôi thối _ XÚ
暗い	くら い _ Tối ;âm u _ ÁM
煙い	けむい _ Khó thở (do khói ) _ YÊN
凄い	すごい _ Tuyệt vời ; khủng; ghê gớm (khen ngợi)
狭い	せまい _ Chật ;hẹp (diện tích) _ HIỆP
広い	ひろい _ Rộng; rộng rãi (diện tích) _ QUẢNG
低い	ひく い _ Thấp (mức độ ) _ ĐÊ
安い	やすい _ Rẻ (giá cả) _ AN, YÊN
高い	たか い _ Cao (mức độ ) ;đắt (giá cả) _ CAO
近い	ちかい _ Gần _ CÂ?N
遠い	とお い _ Xa; xa xôi _ VIỄN
強い	つよい _ Mạnh ; khỏe _ CƯỜNG, CƯỠNG(MIỄN)
弱い	よわい _ Yếu; yếu ớt _ NHƯỢC
諄い	くどい _ Bướng bỉnh ;hợm hĩnh
狡い	ずるい _ Xảo trá ; gian trá
憎い	にくい _ Khó gần ;dễ ghét _ TĂNG
鈍い	にぶい _ Đần độn ; chậm hiểu _ ĐỘN
醜 い	みにくい _ Xấu xí ;khó coi _ XÚ
辛い	つらい _ Chán ;nhàm chán _ TÂN
面白い	おもし ろい _ Thú vị ; hài hước (tính cách) _ DIỆN BẠCH
鈍い	のろい _ Bình chân như vại ;chậm chạp _ ĐỘN
賢い	かしこい _ Thông minh ;linh hoạt; lanh lẹ _ HIỀN
酷い	ひど い _ Nghiêm trọng ;trầm trọng _ KHỐC
太い	ふとい _ Béo ;mập _ THÁI
細い	ほそ い _ Thon thả (dáng người) ;thon dài _ TẾ
まずい	まずい _ Dở ; không ngon (vị )
丸い	まるい _ Tròn _ HÒAN
若い	わかい _ Trẻ _ NHƯỢC
眠い	ねむい _ Buồn ngủ _ MIÊN
危 うい	あやうい _ Nguy hiểm ;suýt nữa thì.... _ NGUY
うるさい	うるさい _ Ồn ào ;náo động (âm thanh) ;lắm chuyện;hay gây sự (tính cách)
青白い	あおじろい _ Xanh nhạt _ THANH BẠCH
薄 暗い	うすぐらい _ Mờ ảo ;tối âm u _ BẠC ÁM
蒸し暑い	むしあつい _ Nóng bức ;nóng ẩm _ CHƯNG THỬ
物 凄い	ものすごい _ Ghê gớm ;khung khiếp (khen ngợi) _ VẬT
力強い	ちからづよい _ Khỏe ;mạnh _ LỰC CƯỜNG, CƯỠNG(MIỄN)
面倒くさい	めんどうくさい _ Phức tạp; phiền phức; rắc rối _ DIỆN ĐẢO
すばしこい・すばしっこい	すばしこい・すばしっこい _ Nhanh nhẹn; thoăn thoắt