一緒に	いっしょに (cùng lúc, cùng nhau - [NHẤT TỰ])
行儀	ぎょうぎ (cách cư xử - [HÀNH, HÀNG, HẠNH NGHI])
メモを取る	メモをとる (ghi chép, ghi nhớ - [THỦ])
一方	いっぽう (một mặt/mặt khác - [NHẤT PHƯƠNG])
話し合い	はなしあい (thảo luận - [THOẠI HỢP])
戦い
(たたかい)	(chiến đấu - [CHIẾN])
続ける	つづける (tiếp tục - [TỤC])
整備	せいび (điều chỉnh, chỉnh sửa - [CHỈNH BỊ])
近代化
(きんだいか)	(hiện đại hóa - [CÂ?N ĐẠI HÓA])
政府	せいふ (chính phủ - [CHÍNH PHỦ])
政策	せいさく (chính sách - [CHÍNH SÁCH])
撤退する
(てったいする)	(rút lui, rút khỏi - [TRIỆT THÓAI])
減らす	へらす (cắt bớt, thu nhỏ, làm giảm - [GIẢM])
シャッターを切る	(bấm nút (chụp hình) - [THIẾT])
話しかける	はなしかける (bắt chuyện - [THOẠI])
元々	もともと (vốn dĩ, nguyên là - [NGUYÊN])
黙る	だまる (giữ yên lặng - [MẶC])
原稿
(げんこう)	(bản thảo, bản nháp - [NGUYÊN CẢO])
穴	あな (hầm, hố, hang, hốc - [HUYỆT])
掘る
(ほる)	(đào, xới - [QUẬT])
土砂崩れ
(どしゃくずれ)	(sự lở đất - [THỔ SA BĂNG])
崩れる
(くずれる)	(đổ, sập, sụp - [BĂNG])
或いは
(あるいは)	(hoặc, hoặc là)
感じ	かんじ (cảm giác - [CẢM])
以外	いがい (ngoại trừ, ngoại lệ - [DĨ NGOẠI])
意思	いし (ý chí - [Ý TƯ])
携帯	けいたい (di động - [HUỀ ĐỚI, ĐÁI])
鳴る	なる (reng, rung (chuông đt) - [MINH])
金庫
(きんこ)	(két sắt, két bạc - [KIM KHỐ])
非常ベル
(ひじょうベル)	(chuông báo động - [PHI THƯỜNG])
腹	はら (bụng - [PHÚC])
腹が立つ
(はらがたつ)	(phát tức - [PHÚC LẬP])
代金	だいきん (tiền hàng, thanh toán - [ĐẠI KIM])
互い
(たがい )	(lẫn nhau, qua lại - [HỖ])
助け合う
(たすけあう )	(hợp tác giúp đỡ lẫn nhau - [TRỢ HỢP])
下ろす	おろす (rút (tiền), hạ xuống, cho xuống, hạ (buồm) - [HẠ])
思い浮かべる
(おもいうかべる)	(nhớ lại, hồi tưởng lại - [TƯ PHÙ])
卒業	そつぎょう (tốt nghiệp - [TỐT, THỐT NGHIỆP])
弁当	べんとう (cơm hộp - [BIỆN ĐANG, ĐƯƠNG])
準備	じゅんび (chuẩn bị - [CHUẨN BỊ])
置き換える
(おきかえる)	(thay thế - [TRỊ HOÁN])
例文	れいぶん (mẫu câu - [LỆ VĂN])
接続	せつぞく (kết nối - [TIẾP TỤC])
注目	ちゅうもく (chú ý, để ý đến - [CHÚ MỤC])
映画	えいが (phim - [HỌA DIỆN])
涙	なみだ (nước mắt - [LỆ])
暫く
(しばらく )	(một chút, một lát - [TẠM])
海外旅行	かいがいりょこう (du lịch nước ngoài - [HẢI NGOẠI LỮ HÀNH])
就職	しゅうしょく (hoạt động tìm việc, nhậm chức - [TỰU CHỨC])
夕方	ゆうがた (hoàng hôn, chiều tối - [TỊCH PHƯƠNG])
際	さい (khi - [TẾ])
抜く	ぬく (rút, nhổ, lược, bỏ - [BẠT])
デジカメ	(máy ảnh kỹ thuật số)
調整する	ちょうせいする (sự điều chỉnh - [ĐIỀU CHỈNH])
仕上がる
(しあがる)	(hoàn thành, rửa (phim) - [SĨ THƯỢNG])
希望	きぼう (kì vọng, hi vọng - [HI VỌNG])
取引先	とりひきさき (khách hàng - [THỦ DẪN TIÊN])
挨拶	あいさつ (chào hỏi)
焼き鳥屋	やきとりや (tiệm gà nướng - [THIÊU ĐIỂU Ốc])
電卓	でんたく (máy tính - [ĐIỆN TRÁC])
訪ねる
(たずねる )	(ghé thăm, hỏi thăm, viếng thăm - [PHỎNG, PHÓNG])
場面	ばめん (bối cảnh, thời điểm - [TRƯỜNG DIỆN])
新婚	しんこん (tân hôn - [TÂN HÔN])
ほやほや	(tươi, mới)
改札口	かいさつぐち (cửa soát vé - [CẢI TRÁT KHẨU])
邪魔する	じゃます (quấy rầy - [TÀ MA])
慣用的な表現
(かんようてきなひょうげん)	(những mẫu câu thường dùng - [QUÁN DỤNG ĐÍCH BIỂU HIỆN])
不動産屋	ふどうさんや (nhà bất động sản - [BẤT ĐỘNG SẢN Ốc])
高校時代	こうこうじだい (thời cấp 3 - [CAO HIỆU THỜI ĐẠI])
利用する	りようする (sử dụng, vận dụng - [LỢI DỤNG])
南口	みなみぐち (cửa phía nam - [NAM KHẨU])
クリーニング	(giặt, ủi)
薄い	うすい (mỏng - [BẠC])
申し込み	もうしこみ (đăng kí - [THÂU NHẬP])
漫画	まんが (truyện tranh - [MẠN HỌA])
レジ	(máy tính tiền)
他の	ほかの (khác - [THA])
降ろす	おろす (xuống (xe) - [GIÁNG])
卸す
(おろす)	(buôn bán sỉ - [TÁ])
卒業する	そつぎょうする (tốt nghiệp - [TỐT NGHIỆP])
都合	つごう (tình huống, điều kiện - [ĐÔNG HỢP])
機会	きかい (cơ hội - [CƠ HỘI])
返す	かえす (trả lại - [PHẢN])
コンビニ	(cửa hàng tiện lợi (コンビニエンスストア))
寄る	よる (ghé qua - [KÝ])
報告書	ほうこくしょ (bản báo cáo - [BÁO CÁO THƯ])
友人	ゆうじん (người bạn - [HỮU NHÂN])
欠伸	あくび (ngáp - [KHUYẾT THÂN])
睨む

(にらむ)	(liếc, lườm)
もともと	(vốn dĩ, nguyên là)
戦う	たたかう (chiến tranh - [CHIẾN])
土砂	どしゃ (đất và cát - [THỔ SA])
赤ん坊
(あかんぼう )	(Em bé sơ sinh - [XÍCH PHƯỜNG])
ニコニコ	(Cười tủm tỉm ,Mỉm cười .)
夢中	むちゅう (say sưa ,đam mê. - [MỘNG TRUNG, TRÚNG])
ウエイトレス	(Chị hầu bàn )
瞬間	しゅんかん (Chốc lát ,giây lát . - [THUẤN GIAN, GIÁN])
粉々
(こなごな)	(Từng mảnh nhỏ - [PHẤN])
床	ゆか (sàn nhà - [SÀNG])
落ちる	おちる (rớt, rơi, rụng - [LẠC])
留守	るす (Sự vắng nhà . - [LƯU THỦ, THÚ])
詳細
(しょうさい)	(Một cách chi tiết ,tường tận . - [TƯỜNG TẾ])
注文	ちゅうもん (Đơn hàng ,sự đặt hàng . - [CHÚ VĂN])
当たり	あたり (Chính xác ,Đúng ,Trúng . - [ĐANG, ĐƯƠNG])
打つ	うつ (đánh; vỗ; đập; va - [ĐẢ])
支払	しはらい (Sự chi trả . - [CHI PHẤT])
リード	(Sự bứt phá )
シュート	(Cú sút bóng .)
同点	どうてん (đồng điểm - [ĐỒNG ĐiỂM])
ホームラン	(homerun - môn bóng chày)
戦争	せんそう (chiến tranh - [CHIẾN TRANH])
タイプ	(loại, kiểu (type))
次第	しだい (tùy theo; tùy thuộc; ngay khi - [THỨ ĐỆ])
終了する
(しゅうりょうする)	(chấm dứt; kết thúc - [CHUNG LIỄU])
過去	かこ (quá khứ; qua; trước - [OA(QUÁ) KHỬ, KHỨ])
気付く
(きづく )	(chú ý đến; để ý; để ý đến; lưu ý;nhận thấy - [KHÍ PHÓ])
確認	かくにん (sự xác nhận; sự khẳng định;sự phê chuẩn, sự chứng minh - [XÁC NHẬN])
覚める
(さめる)	(tỉnh dậy; tỉnh giấc - [GIÁC])
激闘
(げきとう)	(chiến đấu khốc liệt - [KÍCH, KHÍCH ĐẤU])
一点差	いってんさ (hơn 1 điểm - [NHẤT ĐiỂM SAI])
勝利する	しょうりする (chiến thắng, thắng cuộc - [THẮNG LỢI])
真剣	しんけん (nghiêm chỉnh, đúng đắn - [CHÂN KiẾM])
決断	けつだん (quyết đoán, quyết định - [QUYẾT ĐÓAN])
首になる
(くび になる)	(đuổi việc, sa thải - [THỦ])
賞を取る	しょうをとる (nhận phần thưởng - [THƯỞNG THỦ])
念願	ねんがん (tâm niệm, nguyện vọng, mong mỏi - [NiỆM NGUYỆN])
感激	かんげき (cảm kích, cảm động - [CẢM KÍCH, KHÍCH])
金銭	きんせん (tiền bạc - [KIM TIỀN])
依頼する	いらいする (nhờ vả - [Y LẠI])
金銭問題	きんせんもんだい (vấn đề tiền bạc, vấn đề tài chính - [KIM TIỀN VẤN ĐỀ])
散々	さんざん (gay go; khốc liệt; dữ dội; buồn thảm - [TẢN, TÁN])
説教	せっきょう (thuyết giáo, thuyết đạo lý - [THUYẾT GIÁO])
貸す	かす (cho vay; cho mượn - [THẢI])
頼む	たのむ (yêu cầu,đề nghị, nhờ cậy - [LẠI])
学部	がくぶ (ngành học - [HỌC BỘ])
悩む	なやむ (lo lắng; buồn phiền - [NÃO])
今回	こんかい (lần này - [KIM HỒI])
立候補	りっこうほ (ra ứng cử - [LẬP HẬU BỔ])
発表会	はっぴょうかい (buổi biểu diễn, buổi ra mắt - [PHÁT BIỂU HỘI])
傷める
(いためる)	(làm đau, gây thương tích - [THƯƠNG])
緊張	きんちょう (căng thẳng - [KHẨN, CẨN TRƯƠNG])
倒れる	たおれる (đổ, ngã, lăn ra bất tỉnh - [ĐẢO])
悔しい	くやしい (tức - [HỐI])
単に	たんに (đơn thuần, đơn giản - [ĐƠN, ĐAN])
採用する
(さいようする)	(tuyển dụng, thuê - [THẢI DỤNG])
商品	しょうひん (hàng hóa, sản phầm - [THƯƠNG PHẨM])
通信販売	つうしんはんばい (buôn ban điện tử - [THÔNG TÍN PHÁN MẠI])
相談する	そうだんする (thảo luận - [TƯƠNG, TƯỚNG ĐÀM])
件	けん (vụ, trường hợp, vấn đề, việc - [KIỆN])
決定	けってい (quyết định - [QUYẾT ĐỊNH])
変更する	へんこうする (thay đổi, biến đổi - [BiẾN CANH])
結論	けつろん (kết luận, quyết định - [KẾT LuẬN])
期待外れ	きたいはずれ (thất vọng - [KỲ ĐÃI NGOẠI])
靴	くつ (giày - [NGOA])
回る	まわる ( đi quanh, quay - [HỒI])
電話口	でんわぐち (ống nói của điện thoại - [ĐiỆN THOẠI KHẨU])
責任者	せきにんしゃ (người phụ trách - [TRÁCH NHIỆM GIẢ])
効率	こうりつ (hiệu suất; năng suất; năng lực - [HIỆU SUẤT])
改革	かいかく (cải cách - [CẢI CÁCH])
残る	のこる (còn lại; sót lại; còn - [TÀN])
履歴書	りれきしょ (bản lý lịch, CV - [LÝ LỊCH THƯ])
受け取る	うけとる ( nhận; tiếp nhận - [THỤ THỦ])
返事	へんじ (sự trả lời; sự đáp lời - [PHẢN SỰ])
大勢の人	おおぜいのひと (nhiều người - [ĐẠI THẾ NHÂN])
子猫	こねこ (mèo con - [TỬ, TÝ MIÊU])
飛び上がる	とびあがる (nhảy lên - [KHIÊU(PHI) THƯỢNG])
両親	りょうしん (cha mẹ - [LƯỠNG THÂN])
議論	ぎろん (thảo luận, tranh luận - [NGHỊ LuẬN])
重ねる	かさねる (chồng lên, chất lên - [TRỌNG, TRÙNG])
恐ろしい	おそろしい (sợ, kinh khủng - [KHỦNG])
大声	おおごえ (giọng to, tiếng to - [ĐẠI THANH])
成果	せいか (thành quả - [THÀNH QUẢ])
観戦	かんせん (xem đá banh ,bóng chày... - [QUAN CHIẾN])
興奮	こうふん (hưng phấn - [HỨNG, HƯNG PHẤN])
放り投げる	ほうりなげる (buông thả, vất bỏ, quăng bỏ - [PHÓNG ĐẦU])
発表する	はっぴょうする (phát biểu, thông báo - [PHÁT BIỂU])
兄弟	きょうだい (anh em - [HUYNH ĐỆ])
大げんか	おおげんか (cải nhau lớn - [ĐẠI])
絶交	ぜっこう (tuyệt giao, chấm dứt quan hệ - [TUYỆT GIAO])
負ける	まける (thua - [PHỤ])
以来	いらい ( sau khi - [DĨ LAI])
年賀状	ねんがじょう ( thiệp mừng năm mới - [NIÊN HẠ TRẠNG])
やり取り	やりとり ( trao đổi - [THỦ])
環境	かんきょう ( môi trường - [HÒAN CẢNH])
シンポジウム	( hội nghị chuyên đề)
参加する	さんかする ( tham gia - [TAM, THAM GIA])
暖房	だんぼう ( hệ thống sưởi, làm nóng - [NÕAN PHÒNG])
軽い	かるい ( nhẹ - [KHINH])
胃	い (bao tử - [VỊ])
隣	となり ( bên cạnh - [LÂN])
覗く	のぞく (nhìn trộm, liếc nhìn)
夫婦	ふうふ ( vợ chồng - [PHU PHỤ])
真っ最中	まっさいちゅう ( giữa lúc cao trào - [CHÂN TỐI TRUNG, TRÚNG])
患者	かんじゃ (bệnh nhân - [HOẠN GIẢ])
助ける	たすける ( cứu giúp - [TRỢ])
努力	どりょく ( nỗ lực - [NỖ LỰC])
契約書	けいやくしょ ( hợp đồng - [KHẾ ƯỚC THƯ])
べきだ	(phải (must))
断わる	ことわる ( từ chối - [ĐÓAN])
引き受ける	ひきうける ( đảm nhận, nhận ( công việc... ) - [DẪN THỤ])
責任	せきにん ( trách nhiệm - [TRÁCH NHIỆM])
最後	さいご ( cuối cùng - [TỐI HẬU])
全力	ぜんりょく ( toàn lực - [TÒAN LỰC])
尽くす	つくす (toàn tâm , toàn lực - [TẬN])
代表	だいひょう ( đại biểu - [ĐẠI BIỂU])
証拠	しょうこ (chứng cứ - [CHỨNG CỨ])
逮捕する	たいほする ( bắt giữ - [ĐẤT BỘ])
食中毒	しょくちゅうどく ( ngộ độc thức ăn - [THỰC TRUNG, TRÚNG ĐỘC])
刺身	さしみ ( gỏi cá / Sasimi - [THÍCH THÂN])
指輪	ゆびわ ( nhẫn - [CHỈ(SÁP, THÁP) LUÂN])
大会	たいかい (đại hội - [ĐẠI HỘI])
マラソン	(maratông; môn chạy đường dài)
完走	かんそう (chạy tới đích - [HÒAN TẨU])
目指す	めざす ( hướng tới, nhắm tới - [MỤC CHỈ(SÁP, THÁP)])
強調	きょうちょう (sự nhấn mạnh - [CƯỜNG, CƯỠNG(MiỄN) ĐiỀU, ĐiỆU])
健康	けんこう (sức khoẻ; tình trạng sức khoẻ - [KIỆN KHANG])
進学	しんがく ( học lên đại học; học lên cao học - [TẤN, TIẾN HỌC])
限る	かぎる (giới hạn; hạn chế - [HẠN])
贅沢	ぜいたく (sự xa xỉ; xa hoa - [TRẠCH])
豊か	ゆたか (phong phú; dư dật; giàu có - [PHONG])
味わう	あじわう (nếm; thưởng thức; nhấm nháp - [VỊ])
アドバイス	(lời khuyên; tư vấn)
成功	せいこう (thành công - [THÀNH CÔNG])
無駄遣い	むだづかい (sự lãng phí tiền , tiêu xài phung phí - [VÔ THỒ KHIỂN. KHIẾN])
道路	どうろ (con đường; con phố - [ĐẠO LỘ])
フリー	(không mất tiền, được miễn phí, tự do)
不規則	ふきそく (không có quy tắc - [BẤT QUI TẮC])
覚悟する	かくごする (chuẩn bị tinh thần; sẵn sàng - [GIÁC NGỘ])
励ます	はげます (cổ vũ; làm phấn khởi; khích lệ - [LỆ])
無心	むしん (sự vô tâm - [VÔ TĂM])
貧しい	まずしい (điêu đứng; nghèo - [BẦN])
真実	しんじつ (chân thật; thật sự - [CHÂN THỰC])
出勤	しゅっきん ( sự đi làm; sự tới nơi làm việc - [XUẤT CẦN])
当事者	とうじしゃ (đương sự; người có liên quan - [ĐANG, ĐƯƠNG SỰ GIẢ])
第三者	だいさんしゃ (người thứ ba; người không liên quan - [ĐỆ TAM GIẢ])
期待	きたい (sự kỳ vọng; sự hy vọng - [KỲ ĐÃI])
諦める	あきらめる (từ bỏ; bỏ cuộc)
流す	ながす (cho chảy đi, làm chảy đi - [LƯU])
新幹線	しんかんせん (tàu siêu tốc - [TÂN CÁN TUYẾN])
引っ越し	ひっこし (dọn nhà, chuyển chỗ ở - [DẪN VIỆT])
資格	しかく (bằng cấp - [TƯ CÁCH])
眠気	ねむけ (cơn buồn ngủ - [MIÊN KHÍ])
選挙	せんきょ (cuộc tuyển cử - [THIÊN(TUYỂN) CỬ])
当選	とうせん (đắc cử - [ĐANG, ĐƯƠNG THIÊN(TUYỂN)])
支持者	しじしゃ (người ủng hộ - [CHI TRÌ GIẢ])
応援	おうえん (cổ vũ, ủng hộ - [ỨNG VIỆN, VIÊN])
怒る	おこる (nổi giận - [NỘ])
大型	おおがた (to lớn, quy mô lớn - [ĐẠI HÌNH])
大掃除	おおそうじ (tổng vệ sinh - [ĐẠI TẢO TRỪ])
意志	いし (ý chí - [Ý CHÍ])
影響	えいきょう (ảnh hưởng - [ẢNH HƯỞNG])
風邪	ふうじゃ (bị cảm , trúng gió - [PHONG TÀ])
濡れる	ぬれる (ướt đẫm)
家庭	かてい (gia đình - [GIA ĐÌNH])
不満	ふまん (bất mãn - [BẤT MÃN])
後悔	こうかい (hối hận, hối tiếc - [HỐI CẢI])
ぐずぐずする	( lần chần, lưỡng lự)
お前	おまえ (mày)
俺	おれ (tao, tôi)
学ぶ	まなぶ (học - [HỌC])
益々	ますます (ngày càng - [ÍCH])
発達	はったつ (sự phát triển - [PHÁT ĐẠT])
路線	ろせん (tuyến đường, lộ trình - [LỘ TUYẾN])
最新	さいしん (sự tối tân; mới nhất - [TỐI TÂN])
著しい	いちじるしい (đáng kể - [TRƯỚC, TRỨ])
気温	きおん (nhiệt độ - [KHÍ ÔN])
競技	きょうぎ (cuộc thi đấu; thi đấu; thi đ - [CẠNH KỸ])
一生懸命	いっしょうけんめい (chăm chỉ; cần mẫn; cần cù - [NHẤT SINH HUYỀN MẠNG, MỆNH])
機関	きかん (cơ quan - [CƠ QUAN])
非常	ひじょう (phi thường; cực kỳ; đặc biệt - [PHI THƯỜNG])
がっかり	(thất vọng; chán nản)
久しぶり	ひさしぶり (lâu rồi ( không gặp) - [CỬU])
長期	ちょうき (thời gian dài; trường kỳ; dài - [TRƯỜNG, TRƯỞNG KỲ])
評価	ひょうか (sự đánh giá - [BÌNH GIÁ])
一流	いちりゅう (hạng nhất; hàng đầu; cao cấp - [NHẤT LƯU])
さすが	(tốt; tuyệt; như mong đợi)
首都	しゅと (thủ đô - [THỦ ĐÔNG])
倒産	とうさん (sự phá sản; sự không trả được - [ĐẢO SẢN])
失う	うしなう (mất; đánh mất; bị tước; lỡ; bỏ - [THẤT])
勤める	つとめる (làm việc; đảm nhiệm - [CẦN])
二酸化炭素	にさんかたんそ (Khí các bô ních; CO2 - [NHỊ TÁN HÓA THAN TỐ])
増加	ぞうか (sự gia tăng; sự thêm vào - [TĂNG GIA])
引き続き	ひきつづき ( tiếp tục; kế đến, tiep theo - [DẪN TỤC])
言い訳	いいわけ (biện hộ; phân trần; biện bạch - [NGÔN DỊCH])
遅刻	ちこく (sự muộn; sự đến muộn - [TRÌ KHẮC])
目覚まし時計	めざましどけい (đồng hồ báo thức - [MỤC GIÁC])
当然な	とうぜんな (đương nhiên; dĩ nhiên - [ĐANG, ĐƯƠNG NHIÊN])
義務	ぎむ (nghĩa vụ; bổn phận - [NGHĨA VỤ])
決意	けつい ( quyết định, quyết tâm - [QUYẾT Ý])
プロ	(chuyên nghiệp)
大幅に	おおはばに (diện rộng - [ĐẠI BỨC])
信号	しんごう (đèn hiệu; đèn giao thông - [TÍN HIỆU])
職場	しょくば (nơi làm việc - [CHỨC TRƯỜNG, TRÀNG])
定休日	ていきゅうび (ngày nghỉ thường kì - [ĐỊNH HƯU NHẬT])
通知	つうち (sự thông báo; sự thông tri - [THÔNG TRI, TRÍ])
告知	こくち (chú ý; thông cáo - [CÁO TRI, TRÍ])
工事中	こうじちゅう (đang xây dựng; đang thi công - [CÔNG SỰ TRUNG, TRÚNG])
協力	きょうりょく (sự hợp tác; hợp tác - [HIỆP LỰC])
好評	こうひょう (tính phổ biến; được đánh giá cao - [HẢO, HIẾU BÌNH])
上映	じょうえい (chiếu phim, công chiếu - [THƯỢNG ÁNH])
延長	えんちょう (sự kéo dài - [DIÊN TRƯỜNG, TRƯỞNG])
離れ	はなれ (rời xa, cách xa - [LY])
旅する	たびする (đi du lịch; du lịch; đi xa - [LỮ])
被害	ひがい (thiệt hại - [BỊ HẠI])
王国	おうこく (vương quốc; - [VƯƠNG QUỐC])
最強	さいきょう (mạnh nhất - [TỐI CƯỜNG, CƯỠNG(MiỄN)])
梅雨	つゆ (mùa mưa - [MAI VŨ])
時期	じき (thời kỳ - [THỜI, THÌ KỲ])
寝坊	ねぼう (ngủ dậy muộn - [TẨM PHƯỜNG])
遭う	あう (gặp phải (tai nạn) - [TAO])
渋滞	じゅうたい (ùn tắc, kẹt xe - [SÁP TRỆ])
直る	なおる (được chữa, được sửa - [TRỰC])
虫歯	むしば (sâu răng, răng sâu - [TRÙNG XỈ])
解ける	とける (mở ra, cởi ra - [GIẢI])
南極	なんきょく (nam cực - [NAM CỰC])
上昇	じょうしょう (tăng lên, tiến bộ - [THƯỢNG THĂNG])
満席	まんせき (hết chỗ ngồi - [MÃN TỊCH])
素晴らしい	すばらしい (tuyệt vời, tráng lệ - [TỐ TÌNH])
感動	かんどう (cảm động - [CẢM ĐỘNG])
目標	もくひょう (mục tiêu - [MỤC TIÊU])
合格	ごうかく (trúng tuyển, thi đậu - [HỢP CÁCH])
進む	すすむ (tiến lên, tiến bộ - [TẤN, TIẾN])
多忙	たぼう (rất bận, bận rộn)
逆説	ぎゃくせつ (ý kiến ngược đời; nghịch biện - [NGHỊCH THUYẾT])
学習	がくしゅう (sự học tập; sự học - [HỌC TẬP])
話し手	はなして (người nói - [THOẠI THỦ])
主語	しゅご (chủ từ；chủ ngữ - [CHỦ NGỮ])
起こす	おこす (khởi đầu - [KHỞI, KHỈ])
煙草	たばこ (thuốc lá - [YÊN THẢO])
吸う	すう (hút (thuốc) - [HẤP])
いやいや	(miễn cưỡng; gượng gạo - [PHỦ PHỦ])
任す	まかす (giao phó, phó thác - [NHIỆM])
机	つくえ (cái bàn - [KỶ])
勝つ	かつ (thắng, chiến thắng - [THẮNG])
誘惑	ゆうわく (sự quyến rũ; sự lôi cuốn - [DỤ HOẶC])
非難	ひなん (sự trách móc; sự phê phán - [PHI NẠN])
軽蔑	けいべつ (sự khinh miệt; sự khinh thường - [KHINH])
翻訳	ほんやく (dịch; sự giải mã - [PHIÊN DỊCH])
状況	じょうきょう (tình trạng; hoàn cảnh - [TRẠNG HUỐNG])
転校	てんこう (chuyển trường - [CHUYỂN HIỆU])
苦労	くろう (sự gian khổ; sự cam go - [KHỔ LAO])
慣れる	なれる (quen với; trở nên quen với - [QUÁN])
専業	せんぎょう (chuyên nghiệp - [CHUYÊN NGHIỆP])
主婦	しゅふ (nội trợ - [CHỦ PHỤ])
株	かぶ (cổ phiếu； - [CHÂU])
売買	ばいばい (buôn bán - [MẠI MÃI])
お見舞い	おみまい (tham bệnh - [KIẾN VŨ])
暮らす	くらす (mưu sinh - [MỘ])
不景気	ふけいき (khung hoảng kinh tế, kinh tế suy thoái - [BẤT CẢNH KHÍ])
けれども	(nhưng, tuy nhiên)
予想外	よそうがい ( ngoài dự kiến - [DƯ TƯỞNG NGOẠI])
驚き	おどろき (sự ngạc nhiên - [KINH])
待ち合わせ	まちあわせ (hẹn gặp - [ĐÃI HỢP])
反対	はんたい (phản đối - [PHẢN ĐỐI])
温暖化	おんだんか (sự ấm lên, nóng lên - [ÔN NÕAN HÓA])
傾向	けいこう (khunh hướng - [KHUYNH HƯỚNG])
越す	こす ( vượt qua - [VIỆT])
不自由	ふじゆう (tàn phế - [BẤT TỰ DO])
面会	めんかい (cuộc gặp gỡ - [DIỆN HỘI])
締め切り	しめきり (hạn cuối, deadline - [ĐẾ THIẾT])
傘を差す	かさをさす (bung dù - [SAI])
高価な	こうかな (đắt, mắc tiền - [CAO GIÁ])
掃除	そうじ (quyét dọn nhà - [TẢO TRỪ])
財布	さいふ (cái ví, bóp - [TÀI BỐ])
出場	しゅつじょう (ra sân, tham gia , tham dự trận đấu - [XUẤT TRƯỜNG, TRÀNG])
残業	ざんぎょう (làm thêm giờ, tăng ca - [TÀN NGHIỆP])
現れる	あらわれる (xuất hiện - [HIỆN])
平日	へいじつ (ngày thường - [BÌNH NHẬT])
授業中	じゅぎょうちゅう (trong giờ học - [THỤ NGHIỆP TRUNG, TRÚNG])
居眠り	いねむり (sự ngủ gật - [CƯ MIÊN])
苦手	にがて (kém, yếu - [KHỔ THỦ])
材料	ざいりょう (vật liệu, nguyên liệu - [TÀI LIỆU])
全く	まったく (toàn bộ, tất cả - [TÒAN])
調査	ちょうさ (sự điều tra - [ĐiỀU, ĐiỆU TRA])
信用	しんよう (Lòng tin; sự tin tưởng; - [TÍN DỤNG])
冷たい	つめたい (lạnh, lạnh lùng - [LÃNH])
田舎	いなか (quên hương, nông thôn - [ĐiỀN XÁ])
極端	きょくたん (cực đoan - [CỰC ĐOAN])
現代	げんだい (hiện nay, hiên đại - [HIỆN ĐẠI])
大企業	だいきぎょう (doanh nghiệp lớn - [ĐẠI XÍ NGHIỆP])
覚える	おぼえる (thuộc, nhớ - [GIÁC])
記憶	きおく (trí nhớ, ký ức - [KÝ ỨC])
周囲	しゅうい (chu vi, vùng chung quanh - [CHU VI])
風穴	かざあな (lỗ thủng, lối thoát, giải pháp - [PHONG HUYỆT])
真夏	まなつ (giữa mùa hè - [CHÂN HẠ])
精神	せいしん (tinh thần；tâm chí - [TINH THẦN ])
酸性雨	さんせいう (mưa acid - [TOAN TÍNH, TÁNH VŨ])
年金	ねんきん (tiền trợ cấp hưu hàng năm - [NIÊN KIM])
本来	ほんらい (từ trước tới nay; từ lúc bắt đầu - [BẢN LAI])
段差	だんさ (chỗ lồi lên, dốc - [ĐOẠN SAI])
自然	しぜん (tự nhiên - [TỰ NHIÊN])
開発	かいはつ (phát triển - [KHAI PHÁT])
破壊	はかい ( phá hủy - [PHÁ HOẠI])
運動	うんどう (vận động, chơi thể thao - [VẬN ĐỘNG])
迷惑	めいわく (quấy rầy, làm phiền - [MÊ HOẶC])
実行	じっこう (thi hành, chấp hành - [THỰC HÀNH, HÀNG, HẠNH])
転勤	てんきん (chuyển chỗ làm - [CHUYỂN CẦN])
海外生活	かいがいせいかつ (cuộc sống ở nước ngoài - [HẢI NGOẠI SINH HỌAT])
合う	あう (hợp, phù hợp - [HỢP])
優勝	ゆうしょう (vô địch - [ƯU THẮNG])
倍	ばい (lần - [BỘI])
借金	しゃっきん (tiền mượn, tiền vay - [TÁ KIM])
親戚	しんせき (bà con thân thuộc; họ hàng - [THÂN THÍCH])
亡く	なく (chết - [VONG])
整形	せいけい (giải phẫn thẩm mỹ - [CHỈNH HÌNH])
手術	しゅじゅつ (mổ; sự phẫu thuật - [THỦ THUẬT])
美しい	うつくしい (đẹp; ưa nhìn; có duyên; xinh - [MỸ])
男性	だんせい (đàn ông - [NAM TÍNH])
親友	しんゆう (bạn thân - [THÂN HỮU])
争う	あらそう (gây gổ; cãi nhau; chiến tranh - [TRANH])
タレント	(tài năng trẻ; ngôi sao mới)
聴く	きく (nghe; lắng nghe - [THÍNH])
エアコン	(máy điều hòa không khí)
効く	きく (có tác dụng; có hiệu quả - [HIỆU])
家事	かじ (công việc gia đình; việc nội trợ - [GIA SỰ])
騒ぐ	さわぐ (gây ồn ào; làm huyên náo - [TAO])
録画	ろくが ( sự ghi hình, quay video - [LỤC HỌA, HOẠCH])
大国	たいこく (nước lớn; cường quốc - [ĐẠI QUỐC])
たっぷり	( đầy ắp, đầy tràn; đầy đủ; )
予報	よほう (dự báo - [DỰ BÁO])
脱ぐ	ぬぐ (cởi (quần áo, giày); bỏ (mũ) - [THÓAT])
皮膚病	ひふびょう (bệnh ngoài da - [BÌ PHU BỆNH])
受験生	じゅけんせい (thí sinh dự thi - [THỤ NGHIỆM SINH])
直前	ちょくぜん (ngay trước khi - [TRỰC TIỀN])
程度	ていど (Mức độ, Trình độ - [TRÌNH ĐỘ])
挙げる	あげる (Nâng lên, đỡ lên, đưa ra (ví dụ) - [CỬ])
比較する	ひかくする (So sánh - [TỶ GIẢO])
慣用的	かんようてき (Thành ngữ - [QUÁN DỤNG ĐÍCH])
作物	さくもつ (Hoa màu, cây trồng - [TÁC VẬT])
渋谷	しぶや (Tên riêng - [SÁP CỐC])
都心	としん (Trung tâm thành phố - [ĐÔNG TĂM])
外見	がいけん (Bề ngoài - [NGOẠI KIẾN])
良子	よしこ (Tên riêng - [LƯƠNG TỬ, TÝ])
町内会	ちょうないかい (Hội nghị thành phố - [THĨNH NỘI HỘi])
羨ましい	うらやましい (Thèm muốn, ghen tỵ)
観光客	かんこうきゃく (Khách du lịch - [QUAN QUANG KHÁCH])
落ち込む	おちこむ (Buồn bã, suy sụp - [LẠC VÀO])
気分	きぶん (Tâm tình; tâm tư; tinh thần - [KHÍ PHÂN])
講演	こうえん (Bài giảng; bài nói chuyện - [GiẢNG DiỄN])
燃える	もえる (Cháy, đốt, nung nóng - [NHIÊN])
桃	もも (Quả đào - [ĐÀO])
初心者	しょしんしゃ (Người bắt đầu, người mới học - [SƠ TĂM GiẢ])
余裕	よゆう (Phần dư, phần thừa ra. - [DƯ DỤ])
輸出額	ゆしゅつがく (Doanh số xuất khẩu - [DU XUẤT NGẠCH])
億	おく (100 triệu - [ỨC])
ドル	(Đô la)
前年	ぜんねん (Năm trước - [TIỀN NIÊN])
喫煙者	きつえんしゃ (Người hút thuốc - [KHIẾT YÊN GIẢ])
非喫煙者	ひきつえんしゃ (Người không hút thuốc - [PHI KHIẾT YÊN GIẢ])
肺がん	はいがん (Ung thư phổi - [PHẾ])
率	りつ (Tỷ lệ - [SUẤT])
罹る	かかる (Bị (bệnh))
収入	しゅうにゅう (Thu nhập - [THU NHẬP])
支出	ししゅつ (Mức chi ra - [CHI XUẤT])
万能	まんのう (Toàn năng; vạn năng - [VẠN NĂNG])
活動的な	かつどうてきな (năng động - [HỌAT ĐỘNG ĐÍCH])
内向的な	ないこうてきな (Sống nội tâm; hướng nội - [NỘI HƯỚNG ĐÍCH])
どちらかというと	(Nói gì thì nói)
海側	かいがわ (Bờ biển - [HẢI TRẮC])
大雪	おおゆき (Tuyết rơi dày - [ĐẠI TUYẾT])
太平洋	たいへいよう (Thái bình dương - [THÁI BÌNH DƯƠNG])
晴天	せいてん (Trời quang đãng - [TÌNH THIÊN])
メディア	(Phương tiện truyền thông)
一方的	いっぽうてき (Phiến diện - [NHẤT PHƯƠNG ĐÍCH])
発信	はっしん (Truyền tín hiệu; phát đi - [PHÁT TÍN])
人手不足	ひとでぶそく (Sự thiếu nhân lực - [NHÂN THỦ BẤT TÚC])
相変わらず	あいかわらず (Như bình thường; như mọi khi - [TƯƠNG, TƯỚNG BiẾN])
若者	わかもの (Người trẻ tuổi - [NHƯỢC GIẢ])
読書離れ	どくしょばなれ (Không ham thích đọc sách - [ĐỘC GIẢ LY])
俳優	はいゆう (Diễn viên - [BÀI ƯU])
出演する	しゅつえんする (Trình diễn; xuất hiện - [XUẤT DIỄN])
活躍	かつやく (hoạt động nổi bật, tích cực - [HỌAT DŨNG(DƯỢC)])
一人暮らし	ひとりくらし (Sống một mình - [NHẤT NHÂN MỘ])
面倒	めんどう (Phiền hà; quấy rầy; khó khăn; trở ngại - [DIỆN ĐẢO])
設備	せつび (Trang thiết bị - [THIẾT BỊ])
利点	りてん (Điểm có lợi - [LỢI ĐiỂM])
授業料	じゅぎょうりょう (Tiền học phí - [THỤ NGHIỆP LIỆU])
楽器	がっき (Nhạc cụ - [NHẠC, LẠC KHÍ])
演奏する	えんそうする (Diễn tấu; trình diễn (âm nhạc) - [DIỄN TẤU, TÂU])
逆	ぎゃく (Ngược lại; tương phản; trái ngược - [NGHỊCH])
地域	ちいき (Khu vực; vùng - [ĐỊA VỰC])
じっくり	(Kỹ lưỡng; kỹ càng; thong thả)
南側	みなみがわ (Bờ phía nam - [NAM TRẮC])
北側	きたがわ (Bờ phía bắc - [BẮC TRẮC])
住宅街	じゅうたくがい (Khu dân cư - [TRÚ TRẠCH NHAI])
正月	しょうがつ (Năm mới; Tết - [CHÍNH NGUYỆT])
党	とう (Đảng (chính trị) - [ĐẢNG])
法案	ほうあん (Dự luật - [PHÁP ÁN])
賛成する	さんせいする (Tán thành - [TÁN THÀNH])
全面的	ぜんめんてきな (Mang tính toàn diện - [TÒAN DIỆN ĐÍCH])
田舎暮らし	いなかくらし (Sống ở nông thôn - [ĐiỀN XÁ MỘ])
観光地	かんこうち (địa điểm du lịch, ngắm cảnh - [QUAN QUANG ĐỊA])
例年	れいねん (thường niên - [LỆ NIÊN])
委員会	いいんかい (ủy viên công chức chính phủ - [ỦY VIÊN HỘI])
施設	しせつ (Thiết bị, cơ sở vật chất - [THI, THÍ THIẾT])
後半	こうはん (Hiệp hai; nửa sau - [HẬU BÁN])
平ら	たいら (Bằng phẳng - [BÌNH])
山歩き	やまあるき (Leo núi, hiking - [SƠN BỘ])
常に	つねに (Lúc nào cũng, luôn luôn - [THƯỜNG])
与える	あたえる (Gây ra;ban tặng; thưởng - [DƯ, DỰ])
感覚	かんかく (Cảm giác - [CẢM GIÁC])
辺り	あたり (Khu vực xung quanh - [BIÊN])
中心部	ちゅうしんぶ (Phần trung tâm - [TRUNG, TRÚNG TĂM BỘ])
家賃	やちん (tiền thuê nhà - [GIA NHẤN])
話題	わだい (chủ đề, đề tài - [THOẠI ĐỀ])
慌ただしい	あわただしい (bận rộn, bận túi bụi - [HỎANG])
酔っ払う	よっぱらう (say rượu - [TÚY PHẤT])
才能	さいのう (tài năng, năng khiếu - [TÀI NĂNG])
芸術家	げいじゅつか (nghệ thuật gia, người làm nghệ thuật - [NGHỆ THUẬT GIA])
地位	ちい (địa vị - [ĐỊA VỊ])
飼う	かう (chăn, nuôi - [TỰ])
動機	どうき (động cơ - [ĐỘNG CƠ])
迷う	まよう (lúng túng, lạc lối , lạc đường - [MÊ])
繰り返する	くりかえする (lặp đi lặp lại - [TẢO PHẢN])
交通整理	こうつうせいり (chỉnh đốn giao thông - [GIAO THÔNG CHỈNH LÝ])
雑誌	ざっし (tạp chí - [TẠP CHÍ])
積む	つむ (chất, xếp, chồng chất - [TÍCH])
電器	でんき (đồ điện - [ĐiỆN KHÍ])
牛乳	ぎゅうにゅう (sữa bò - [NGƯU NHŨ])
切符	きっぷ (vé - [THIẾT PHÙ])
面接	めんせつ (phỏng vấn - [DIỆN TIẾP])
展示会	てんじかい (cuộc triển lãm, cuộc trưng bày - [TRIỂN THỊ HỘI])
適当	てきとう (tương thích,phù hợp - [THÍCH ĐANG, ĐƯƠNG])
開催	かいさい (tổ chức - [KHAI THÔI])
貯金	ちょきん (tiết kiệm tiền - [TRỮ KIM])
減る	へる (suy giảm, giảm bớt - [GIẢM])
超高齢化社会になる	ちょうこうれいかしゃかいになる (xã hội có xu hướng già đi (tỉ lệ người cao tuổi cao) - [SIÊU CAO LINH HÓA XÃ HỘI])
景気	けいき (tình hình kinh tế - [CẢNH KHÍ])
回復する	かいふくする (hồi phục, khôi phục - [HỒI PHỤC])
アトラクション	(chương trình văn nghệ)
遊園地	ゆうえんち (khu vực vui chơi, khu vực giải trí - [DU VIÊN ĐỊA])
戻る	もどる (quay lại, trở lại - [LỆ])
厳しい	きびしい (hà khắc, khắt khe - [NGHIÊM])
狭い	せまい (chật hẹp - [HIỆP])
やっばり	(đương nhiên, rõ ràng - [THỈ TRƯƠNG])
変化	へんか (Thay đổi - [BiẾN HÓA])
背	せ (lưng - [BÔ?I, BỘI])
教育費	きょういくひ (chi phí đào tạo, nuôi dưỡng - [GIÁO DỤC PHÍ])
年寄り	としより (Người già - [NIÊN KÝ])
体力	たいりょく (thể lực, sức khỏe - [THỂ LỰC])
低下	ていか (giảm, kém đi, suy giảm - [ĐÊ HẠ])
記憶力	きおくりょく (trí nhớ - [KÝ ỨC LỰC])
衰える	おとろえる (yếu đi, suy nhược, suy tàn - [SUY])
近付く	ちかづく (gần tới, gần đến - [CÂ?N PHÓ])
何だか	なんだか (không hiểu vì sao , không hiểu sao - [HÀ])
わくわくする	(hồi hộp)
高齢	こうれい (cao tuổi - [CAO LINH])
減少	げんしょう (suy giảm, giảm bớt - [GIẢM THIỂU, THIẾU])
街	まち (phố phưởng, phố xá - [NHAI])
活気	かっき (sự hoạt bát, sự sôi nổi, đầy sức sống - [HỌAT KHÍ])
様子	ようす (trạng thái - [DẠNG TỬ, TÝ])
向ける	むける (hướng về phía, phù hợp với - [HƯỚNG])
辞める	やめる (nghỉ (việc) - [TỪ])
対比する	たいひする (so sánh - [ĐỐI TỶ])
対照	たいしょう (Sự đối chiếu - [ĐỐI CHIẾU])
面	めん (Khía cạnh; phương diện - [DIỆN])
都会	とかい (Thành thị; thành phố - [ĐÔHộI])
成績	せいせき ( thành tích - [THÀNH TÍCH])
例え	たとえ (ví dụ, giả dụ - [LỆ])
犯人	はんにん (hung thủ, phạm nhân - [PHẠM NHÂN])
のんびり	(thong thả; thong dong)
大好物	だいこうぶつ (món ăn rất ưu thích - [HẢO, HIẾU VẬT])
不況	ふきょう (kinh tế suy thoái - [BẤT HUỐNG])
転職	てんしょく (chuyển việc - [CHUYỂN CHỨC])
売り上げ	うりあげ (bán ra - [MẠI THƯỢNG])
伸びる	のびる (kéo dài; lớn lên; lan ra - [THÂN])
当日	とうじつ ( ngày hôm đó - [ĐANG, ĐƯƠNG NHẬT])
育ち	そだち (nuôi nấng - [DỤC])
南国	なんごく (các nước phía nam - [NAM QUỐC])
本物	ほんもの (đồ thật - [BẢN VẬT])
ダイヤモンド	(kim cương)
郵便	ゆうびん (bưu kiện, bưu phẩm - [BƯU TIỆN])
寮	りょう (Ký túc xá - [LIÊU])
洗濯	せんたく (Sự giặt giũ, sự gột rửa, sự tẩy rửa - [TiỂN TRẠC])
大変	たいへん (Kinh khủng; dễ sợ; khủng khiếp; rất, quá - [ĐẠI BiẾN])
遊ぶ	あそぶ (Chơi; đi chơi - [DU])
試験	しけん (Kỳ thi; thi cử - [THÍ NGHIỆM])
ぶらぶら	(đu đưa; không mục đích; nhàn rỗi; lờ đờ; đi tha thẩn; rong chơi; nhàn rỗi; đi dạo nhàn rỗi)
連絡	れんらく (Liên lạc - [LIÊN LẠC])
否定	ひてい (phủ định - [PHỦ ĐỊNH])
登場	とうじょう (xuất hiện - [ĐĂNG TRƯỜNG, TRÀNG])
リーダー	(độc giả; người lãnh đạo)
手拍子	てびょうし (cẩu thả, bất cẩn - [THỦ PHÁCH TỬ, TÝ])
被災者	ひさいしゃ (nạn nhân thiên tai - [BỊ TAI GIẢ])
ボランティア活動	ボランティアかつどう ( công tác từ thiện - [HỌAT ĐỘNG])
苦い	にがい (đắng - [KHỔ])
絶対	ぜったい (tuyệt đối - [TUYỆT ĐỐI])
閉ざす	とざす (bịt lại; bít lại；ngăn lại; - [BẾ])
満員	まんいん (đông người; chật ních người - [MÃN VIÊN])
必死	ひっし (quyết tâm, quyết tử, liều chết - [TẤT TỬ])
足を踏ん張る	あしをふんばる (xuống tấn, trụ chân lại - [TÚC ĐẠP TRƯƠNG])
アルコール	(cồn; rượu)
勧める	すすめる (khuyên - [KHUYẾN])
効果的	こうかてき (Có hiệu quả, có hiệu lực - [HIỆU QUẢ ĐÍCH])
伝える	つたえる (Truyền, truyền đạt. - [TRUYỀN, TRUYỆN])
肩	かた (Vai, bờ vai - [KHIÊN])
凝る	こる (Đông cứng, đông lại - [NGƯNG])
夜中	よなか (Nửa đêm, ban đêm - [DẠ TRUNG, TRÚNG])
嫌い	きらい (Đáng ghét; không ưa; không thích, ghét - [HIỀM])
不思議	ふしぎ (kỳ quái, kỳ lạ - [BẤT TƯ NGHỊ])
最近	さいきん (Gần đây, mới đây - [TỐI CÂ?N])
意識	いしき (Ý thức - [Ý THỨC])
店長	てんちょう (Chủ cửa hàng; người quản lý cửa hàng - [ĐiẾM TRƯỜNG, TRƯỞNG])
捨てる	すてる (Vứt bỏ - [XẢ])
景色	けしき (Cảnh sắc, phong cảnh - [CẢNH SẮC])
入院	にゅういん (Nhập viện - [NHẬP ViỆN])
退屈	たいくつ ( buồn tẻ; chán ngắt - [THÓAI KHUẤT])
地震	じしん (Động đất - [ĐỊA CHẤN])
企業	きぎょう (Xí nghiệp; doanh nghiệp - [XÍ NGHIỆP])
爆発	ばくはつ (Sự bộc phát; vụ nổ lớn - [BỘC PHÁT])
消す	けす (tắt, tẩy, xóa, dụi - [TIÊU])
朝起き	あさおき (thức dậy sớm - [TRIỀU KHỞI, KHỈ])
磨く	みがく (mài, dũa, làm bóng - [MA])
不安	ふあん (không yên tâm; bất an - [BẤT AN, YÊN])
似合う	にあう ( hợp; tương xứng; vừa - [TỰ HỢP])
停電	ていでん ( cúp điện - [ĐÌNH ĐiỆN])
自家	じか ( nhà của mình - [TỰ GIA])
発電	はつでん (sự phát điện - [PHÁT ĐiỆN])
良質	りょうしつ (chất lượng tốt - [LƯƠNG CHẤT])
上質	じょうしつ (chất lượng tốt - [THƯỢNG CHẤT])
日本酒	にほんしゅ (rượu Nhật - [NHẬT BẢN TỬU])
視聴率	しちょうりつ (tỉ lệ người xem - [THỊ THÍNH SUẤT])
ピアニスト	(người chơi đàn piano)
不足	ふそく (không đủ; không đầy đủ; thiếu; - [BẤT TÚC])
各駅停車	かくえきていしゃ (tàu đỗ ở tất cả các ga - [CÁC DỊCH ĐÌNH XA])
サボる	(trốn học; trốn việc)
探す	さがす (tìm kiếm, lục lọi - [THÁM])
アニメ	(phim hoạt hình)
田んぼ	たんぼ (ruộng lúa, ruộng nước - [ĐiỀN])
角度	かくど (Góc độ, khía cạnh, quan điểm - [GIÁC ĐỘ])
栄養	えいよう (Dinh dưỡng - [VINH DƯỠNG])
交渉	こうしょう (Đàm phán - [GIAO THIỆP])
世辞	せじ (Tâng bóc, tán dương, ca tụng - [THẾ TỪ])
恵まれる	めぐまれる (Được ban cho - [HUỆ])
記録	きろく (Sự ghi chép, ghi lại - [KÝ LỤC])
推量	すいりょう (Sự đoán, phỏng đoán - [SUY LƯỢNG])
根拠	こんきょ (Nền tảng, căn cứ, đáy - [CĂN CỨ])
年配者	ねんぱいしゃ (Bậc tiền bối - [NIÊN PHỐI GIẢ])
頼りない	たよりない (Không đáng tin, không nhờ cậy được)
跡	あと (Dấu vết, dấu tích - [TÍCH])
桜が咲く	さくらがさく (Hoa anh đào nở - [ANH TIẾU])
企画案	きかくあん (Bảng kế hoạch - [XÍ HỌA, HOẠCH ÁN])
椅子	いす (ghế; cái ghế - [TỬ, TÝ])
材質	ざいしつ (chất liệu - [TÀI CHẤT])
ぴったり	(vừa khít, khớp, vừa vặn)
庭	にわ (vườn, sân vườn - [ĐÌNH])
派手	はで (lòe loẹt; màu mè; sặc sỡ - [PHÁI THỦ])
預かる	あずかる (giữ, cất giữ - [DỰ])
信じる	しんじる (tin tưởng; tin vào - [TÍN])
丸々	まるまる (hoàn toàn - [HÒAN])
一個	いっこ (một cái; một cục; một viên. - [NHẤT CÁ])
ジム	(thể dục thẩm mỹ; phòng thể dục)
筋トレ	きんトレ (luyện tập cơ bắp ( cử tạ...) - [CÂN])
助詞	じょし (trợ từ - [TRỢ TỪ])
限定	げんてい (sự hạn định; sự hạn chế - [HẠN ĐỊNH])
軽視	けいし (sự khinh thường; sự xem nhẹ - [KHINH THỊ])
価値	かち (giá - [GIÁ TRỊ])
誕生日	たんじょうび (ngày sinh nhật - [ĐẢN SINH NHẬT])
ウイスキー	(rượu whisky)
高熱	こうねつ (sốt cao - [CAO NHIỆT])
納豆	なっとう (đậu nành lên men - [NẠP ĐẬU])
首相	しゅしょう (thủ tướng - [THỦ TƯƠNG, TƯỚNG])
語学力	ごがくりょく (khả năng ngôn ngữ - [NGỮ HỌC LỰC])
立場	たちば (lập trường - [LẬP TRƯỜNG, TRÀNG])
事故	じこ (sự cố - [SỰ CỐ])
現場	げんば (hiện trường - [HIỆN TRƯỜNG, TRÀNG])
新製品	しんせいひん (sản phẩm mới - [TÂN CHẾ PHẨM])
看護師	かんごし (y tá - [KHÁN HỘ SƯ])
老人	ろうじん (người già - [LÃO NHÂN])
手段	しゅだん (phương tiện - [THỦ ĐỌAN])
監督	かんとく (đạo diễn - [GIAM, GIÁM ĐỐC])
採用	さいよう (tuyển dụng - [THẢI DỤNG])
珍しい	めずらしい (hiếm - [TRÂN])
後輩	こうはい (hậu bối - [HẬU BỐI])
江戸時代	えどじだい (thời đại Edo - [GIANG HỘ THỜI, THÌ ĐẠI])
素人	しろうと (dân nghiệp dư - [TỐ NHÂN])
他人	たにん (người khác - [THA NHÂN])
甘やかす	あまやかす (nuông chiều - [CAM])
表面上	ひょうめんじょう (vẻ bên ngoài - [BIỂU DIỆN THƯỢNG])
進行上	しんこうじょう (tiến độ - [TẤN, TIẾN HÀNH, HÀNG, HẠNH THƯỢNG])
休憩	きゅうけい (nghỉ giải lao - [HƯU KHẾ])
解決	かいけつ (giải quyết - [GIẢI QUYẾT])
連絡先	れんらくさき (địa chỉ liên hệ - [LIÊN LẠC TIÊN])
主張	しゅちょう (chủ trương - [CHỦ TRƯƠNG])
判断	はんだん (phán đoán - [PHÁN ĐÓAN])
得る	える (lấy được, đoạt được, được - [ĐẮC])
検査	けんさ (kiêm tra - [KIỂM TRA])
故障	こしょう (sự hỏng - [CỐ CHƯỚNG])
昨晩	さくばん (tối hôm qua - [TẠC VÃN])
二日酔い	ふつかよい (nhức đầu vì say rượu hôm trước - [TÚY])
賛成	さんせい (tán thành, phê chuẩn - [TOAN THÀNH])
要望	ようぼう (lời thỉnh cầu, lời đề nghị - [YÊU, YẾU VỌNG])
給料	きゅうりょう (lương - [CẤP LIỆU])
津波	つなみ (sóng thần - [TÂN BA])
薬指	くすりゆび (ngón tay đeo nhẫn - [DƯỢC CHỈ(SÁP, THÁP)])
欠航する	けっこうする (hoãn cung cấp dịch vụ - [KHUYẾT HÀNG])
後ろ姿	うしろすがた (nhìn từ đằng sau - [HẬU TƯ])
漏れる	もれる (rò rĩ - [LẬU])
秘密	ひみつ (bí mật - [BÍ MẬT])
機械	きかい (máy móc - [CƠ GIỚI])
嬉しい	うれしい (hạnh phúc)
笑顔	えがお (mặt cười - [TiẾU NHAN])
生かす	いかす (Phát huy; tận dụng - [SINH] - 例えば： いかす)
乾燥	かんそう (Sự khô; sự khô hạn - [CAN TÁO] - 例えば： かんそう)
海水	かいすい (Nước biển; nước mặn - [HẢI THỦY] - 例えば： かいすい)
シェフ	(Đầu bếp; cheft)
各国	かくこく (Các nước; các quốc gia - [CÁC QUỐC] - 例えば： かくこく)
核兵器	かくへいき (Vũ khí hạt nhân - [HẠCH BINH KHÍ] - 例えば： かくへいき)
保有	ほゆう (sở hữu, chiếm giữ - [BẢO HỮU] - 例えば： ほゆう)
流行する	はやりする / りゅうこうする (Sự lưu hành; thịnh hành - [LƯU HÀNH, HÀNG, HẠNH] - 例えば： はやりする / りゅうこうする)
インフルエンザ	(Bệnh cúm; cảm cúm)
汚染	おせん (Sự ô nhiễm - [Ô NHIỄM] - 例えば： おせん)
広がる	ひろがる (Lan ra; lan rộng - [QUẢNG] - 例えば： ひろがる)
国内	こくない (Nội địa; trong nước - [QUỐC NỘI] - 例えば： こくない)
農薬	のうやく (Thuốc trừ sâu - [NÔNG DƯỢC] - 例えば： のうやく)
気になる	きになる (Lo ngại; lo lắng; băn khoăn; bực bội, bứt rứt; khó chịu; phiền phức - [KHÍ] - 例えば： きになる)
ネット	(Net)
オークション	(Đấu giá; bán đấu giá)
大小	だいしょう (Kích cỡ - [ĐẠI TIỂU] - 例えば： だいしょう)
送別会	そうべつかい (Buổi liên hoan chia tay - [TỐNG BIỆT HỘI] - 例えば： そうべつかい)
募集	ぼしゅう (Sự chiêu tập; sự chiêu mộ; sự tuyển mộ - [MỘ TẬP] - 例えば： ぼしゅう)
天候	てんこう (Tiết trời;thời tiết - [THIÊN HẬU] - 例えば： てんこう)
酷い	ひどい (Tàn khốc; kinh khủng; tàn nhẫn - [KHỐC] - 例えば： ひどい )
畑	はたけ (Ruộng nương - [VƯỜN] - 例えば： はたけ)
出て行く	でていく (Đi ra - [XUẤT HÀNH, HÀNG, HẠNH] - 例えば： でていく)
品物	しなもの (Hàng hóa; - [PHẨM VẬT] - 例えば： しなもの)
古新聞	ふるしんぶん (Báo cũ - [CỔ TÂN VĂN] - 例えば： ふるしんぶん)
古雑誌	ふるざっし (Tạp chí cũ - [TẠP CHÍ] - 例えば： ふるざっし)
無料	むりょう (Miễn phí - [VÔ LIỆU] - 例えば： むりょう)
沿う	そう (Chạy dài; chạy theo suốt; dọc - [DUYÊN] - 例えば： そう)
盛ん	さかん (Phổ biến; thịnh hành; phát đạt - [THỊNH] - 例えば： さかん)
葬式	そうしき (Đám tang; lễ tang - [TÁNG THỨC] - 例えば： そうしき)
使用	しよう (Sử dụng - [SỬ DỤNG] - 例えば： しよう )
女優	じょゆう (Nữ diễn viên - [NỮ ƯU] - 例えば： じょゆう )
謝る	あやまる (Xin lỗi, tạ lỗi - [TẠ] - 例えば： あやまる)
閉店	へいてん (Đóng cửa cửa hàng - [BẾ ĐiẾM] - 例えば： へいてん)
我がまま	わがまま (Ích kỷ, lợi ích bản thân - [NGÃ] - 例えば： わがまま)
作曲	さっきょく (Sáng tác nhạc - [TÁC KHÚC] - 例えば： さっきょく)
天才	てんさい (Thiên tài - [THIÊN TÀI] - 例えば： てんさい)
断定的	だんていてき (Tính quyết định - [ĐÓAN ĐỊNH ĐÍCH] - 例えば： だんていてき)
モーツアルト	(Mozart)
ニーズ	(Nhu cầu (Need))
ワクチン	(Vắc xin (Vaccine))
フリーマーケット	(Thị trường tự do (Free market))
記事	きじ (Phóng sự, tin tức báo chí. - [KÝ SỰ] - 例えば： きじ)
写す	うつす (In tráng ( hình) , sao chép - [TẢ] - 例えば： うつす)
税金	ぜいきん (Thuế, tiền thuế. - [THUẾ KIM] - 例えば： ぜいきん)
保険料	ほけんりょう (Phí bảo hiểm - [BẢO HiỂM LIỆU] - 例えば： ほけんりょう)
値下	ねさげ (Giá giảm - [TRỊ HẠ] - 例えば： ねさげ)
上向き	うわむき (Khuynh hướng đi lên (khuynh hướng phát triển ). - [THƯỢNG HƯỚNG] - 例えば： うわむき)
延期する	えんきする (Hoãn lại, lui kì hẹn lại - [DIÊN KỲ] - 例えば： えんきする)
分厚い	ぶあつい (Dày, nặng - [PHÂN HẬU] - 例えば： ぶあつい)
治療代	ちりょうだい (Phí trí liệu - [TRỊ LiỆU ĐẠI] - 例えば： ちりょうだい)
発売	はつばい (Sự bán ra, phát hành. - [PHÁT MẠI] - 例えば： はつばい)
バーゲン	(Sự mua bán, sự mặc cả mua bán )
少子化	しょうしか (Giảm tỉ lệ sinh, kế hoạch hóa. - [THIỂU, THIẾU TỬ, TÝ HÓA] - 例えば： しょうしか)
一泊	いっぱく (Trọ lại một đêm - [NHẤT BẠC] - 例えば： いっぱく)
期間	きかん (Thời kì; giai đoạn; thời hạn; kỳ hạn - [KỲ GIAN, GIÁN] - 例えば： きかん)
予想	よそう (Sự báo trước; phán đoán - [DƯ TƯỞNG] - 例えば： よそう)
頃	ころ (Khi; khoảng; lúc - [KHOẢNH] - 例えば： ころ)
昼食	ちゅうしょく (Bữa ăn trưa - [TRÚ THỰC] - 例えば： ちゅうしょく)
治安	ちあん (Trị an, an ninh - [TRỊ AN, YÊN] - 例えば： ちあん)
晴れ	はれ (Trời nắng - [TÌNH] - 例えば： はれ)
トレーニング	(Sự tập huấn; học tập; training)
食料品	しょくりょうひん (Thực phẩm; nguyên liệu nấu ăn - [THỰC LIỆU PHẨM] - 例えば： しょくりょうひん)
商店	しょうてん (Cửa hàng buôn bán; cửa hiệu - [THƯƠNG ĐiẾM] - 例えば： しょうてん)
都内	とない (Khu vực thủ đô - [ĐÔNG NỘI] - 例えば： とない)
北海道	ほっかいどう (Hokkaido (Địa danh) - [BẮC HẢI ĐẠO] - 例えば： ほっかいどう)
沖縄	おきなわ (Okinawa (Địa danh) - [XUNG, TRÙNG THẰNG] - 例えば： おきなわ)
送料	そうりょう (Cước phí gửi hàng - [TỐNG LIỆU] - 例えば： そうりょう)
地元	じもと (Địa phương; trong vùng - [ĐỊA NGUYÊN] - 例えば： じもと)
経営	けいえい (Kinh doanh, buôn bán - [KINH DOANH, DINH] - 例えば： けいえい)
相談	そうだん (Thảo luận, trao đổi - [TƯƠNG, TƯỚNG ĐÀM] - 例えば： そうだん)
有らゆる	あらゆる (Tất cả; mỗi; mọi - [HỮU] - 例えば： あらゆる)
奴	やつ (gã ấy, thằng ấy - [NÔ] - 例えば： やつ)
裏	うら (bề trái - [LÝ] - 例えば： うら)
防犯	ぼうはん (Sự phòng chống tội phạm - [PHÒNG PHẠM] - 例えば： ぼうはん)
ブラウス	(Áo cánh; áo sơ mi tay bồng; áo bờ-lu)
溜まる	たまる (đọng lại, ứ lại, dồn lại)
只	ただ (miễn phí)
異文化	いぶんか (nền văn hóa khác nhau - [DỊ VĂN HÓA] - 例えば： いぶんか)
迫力	はくりょく (sức lôi cuốn, sức quyến rũ - [BÁCH LỰC] - 例えば： はくりょく)
パート	((công việc) bán thời gian)
残業する	ざんぎょうする (làm thêm, làm ngoài giờ - [TÀN NGHIỆP] - 例えば： ざんぎょうする)
定価	ていか (giá xác định, giá ghi trên hàng hóa - [ĐỊNH GIÁ] - 例えば： ていか)
バーゲンセール	(đại hạ giá)
遠慮する	えんりょする (dè dặt, làm khách, ngượng ngùng - [VIỄN LỰ] - 例えば： えんりょする)
古里	ふるさと (quê hương, nơi chôn nhau cắt rốn - [CỔ LÝ] - 例えば： ふるさと)
瀬戸内海	せとないかい (biển ở sâu trong nội địa - [LẠI HỘ NỘI HẢI] - 例えば： せとないかい)
労働	ろうどう (lao động - [LAO ĐỘNG] - 例えば： ろうどう)
感性	かんせい (cảm tính, tình cảm - [CẢM TÍNH] - 例えば： かんせい)
落とす	おとす (đánh rơi - [LẠC] - 例えば： おとす)
慌てる	あわてる (vội vàng, luống cuống, bối rối - [HỎANG] - 例えば： あわてる)
曲	きょく (ca khúc)
事件	じけん (sự kiện, sự việc - [SỰ KIỆN] - 例えば： じけん)
ドーム	(tòa nhà mái tròn)
対策	たいさく (biện pháp, đối sách - [ĐỐI SÁCH] - 例えば： たいさく)
早急な	そうきゅうな (khẩn cấp - [TẢO CẤP] - 例えば： そうきゅうな )
確か	たしか (Chính xác, xác thực - [XÁC] - 例えば： たしか)
性格	せいかく (Tâm trạng, trạng thái, tính tình - [TÍNH CÁCH] - 例えば： せいかく)
滝	たき (Thác nước - [LONG] - 例えば： たき )
心臓	しんぞう (Trái tim - [TĂM TẠNG] - 例えば： しんぞう )
進歩	しんぽ (Tiến bộ - [TẤN, TIẾN BỘ] - 例えば： しんぽ )
誘う	さそう (Mời, rủ rê - [DỤ] - 例えば： さそう)
親しい	したしい (Thân thiết, đầm ấm - [THÂN] - 例えば： したしい)
混乱する	こんらんする (Hỗn loạn; lộn xộn - [HỖN LOẠN] - 例えば： こんらんする)
分別	ぶんべつ (Phân loại; phân tách; chia tách - [PHÂN BIỆT] - 例えば： ぶんべつ)
海外出張する	かいがいしゅっちょうする (Công tác nước ngoài - [HẢI NGOẠI XUẤT TRƯƠNG] - 例えば： かいがいしゅっちょうする)
お買い上げ	おかいあげ (Mua, thu mua - [MÃI THƯỢNG] - 例えば： おかいあげ)
保証期間	ほしょうきかん (Thời hạn bảo đảm, thời gian bảo hành - [BẢO CHỨNG KỲ GIAN, GIÁN] - 例えば： ほしょうきかん)
殺人	さつじん (Tên sát nhân; tên giết người - [SÁT, SÁI NHÂN] - 例えば： さつじん)
玉子	たまご (Trứng (cá, ...) - [NGỌC TỬ, TÝ] - 例えば： たまご)
パック	(Bao gói)
中止する	ちゅうしする (Cấm; ngừng - [TRUNG, TRÚNG CHỈ] - 例えば： ちゅうしする)
月刊誌	げっかんし (Tạp chí phát hành theo tháng - [NGUYỆT SAN CHÍ] - 例えば： げっかんし)
喫煙	きつえん (Hút thuốc - [NGẠT, KHIẾT YÊN] - 例えば： きつえん)
各自	かくじ (Mỗi; mỗi cái riêng rẽ;riêng; mỗi cá nhân - [CÁC TỰ] - 例えば： かくじ)
増す	ます (Làm tăng lên - [TĂNG] - 例えば： ます)
飲み明かす	のみあかす (Uống tới sáng - [ẨM MINH] - 例えば： のみあかす)
助言	じょげん (Lời khuyên ,Lời hướng dẫn - [TRỢ NGÔN] - 例えば： じょげん)
譲る	ゆずる (Nhường ,nhượng bộ - [NHƯỠNG] - 例えば： ゆずる)
温泉	おんせん (Suối nước nóng - [ÔN TUYỀN] - 例えば： おんせん)
危ない	あぶない (Nguy hiểm - [NGUY] - 例えば： あぶない)
言い換える	いいかえる (Nói cách khác - [NGÔN HÓAN] - 例えば： いいかえる)
判定	はんてい (Sự phán định; sự phân định - [PHÁN ĐỊNH] - 例えば： はんてい)
スタイル	(Thân hình；kiểu cách; loại)
センス	(Cảm giác; cảm nhận)
主食	しゅしょく (Món chính - [CHỦ THỰC] - 例えば： しゅしょく)
記入する	きにゅうする (Ghi vào; điền vào; viết vào - [KÝ NHẬP] - 例えば： きにゅうする)
ご存知	ごぞんじ (Biết - [TỒN TRI, TRÍ] - 例えば： ごぞんじ)
踊る	おどる (Ｎhảy múa)
怒鳴る	どなる (Gào lên; hét lên - [NỘ MINH] - 例えば： どなる)
散る	ちる (Rơi; rụng - [TẢN, TÁN] - 例えば： ちる)
日常	にちじょう (Ngày thường - [NHẬT THƯỜNG] - 例えば： にちじょう)
油	あぶら (Dầu; mỡ rán - [DU] - 例えば： あぶら)
油っぽい	あぶらっぽい (Béo ngậy; nhiều dầu mỡ - [DU] - 例えば： あぶらっぽい)
忘年会	ぼうねんかい (Bữa tiệc cuối năm; bữa tiệc tổng kết cuối năm - [VONG NIÊN HỘI] - 例えば： ぼうねんかい)
予約	よやく (Sự đặt trước; sự hẹn trước - [DƯ ƯỚC] - 例えば： よやく)
暮らし	くらし (Cuộc sống; việc sinh sống - [MỘ] - 例えば： くらし)
交通事故	こうつうじこ (Tai nạn giao thông - [GIAO THÔNG SỰ CỐ] - 例えば： こうつうじこ)
訳	わけ (Lý do; nguyên nhân - [DỊCH] - 例えば： わけ)
道理	どうり (Sự hợp lý; lý do; việc đúng với đạo lý - [ĐẠO LÝ] - 例えば： どうり)
事情	じじょう (Tình hình; sự tình; lí do; nguyên cớ - [SỰ TÌNH] - 例えば： じじょう)
自給	じきゅう (Sự tự lực - [TỰ CẤP] - 例えば： じきゅう)
納得	なっとく (Đồng ý, lý giải - [NẠP ĐẮC] - 例えば： なっとく)
輸入品	ゆにゅうひん (Hàng nhập khẩu - [DU NHẬP PHẨM] - 例えば： ゆにゅうひん)
塾	じゅく (Trường tư thục - [THỤC] - 例えば： じゅく)
絵	え (Tranh - [HỘI] - 例えば： え)
食欲	しょくよく (thèm ăn - [THỰC DỤC] - 例えば： しょくよく)
生	なま ((bia) tươi, sống, chưa chế biến - [SINH] - 例えば： なま)
素直	すなお (sự thành thật, ngoan ngoãn - [TỐ TRỰC] - 例えば： すなお)
割引	わりびき ( sự giảm giá - [CÁT DẪN] - 例えば： わりびき)
入場料	にゅうじょうりょう (phí vào cửa - [NHẬP TRƯỜNG, TRÀNG LIỆU] - 例えば： にゅうじょうりょう)
海水魚	かいすいぎょ ( cá nước mặn - [HẢI THỦY NGƯ] - 例えば： かいすいぎょ)
枝豆	えだまめ (hạt còn xanh , chưa chín - [CHI ĐẬU] - 例えば： えだまめ)
海岸	かいがん ( bờ biển - [HẢI NGẠN] - 例えば： かいがん)
土日	どにち ( cuối tuần (thứ 7 và chủ nhật) - [THỔ NHẬT] - 例えば： どにち)
上級者	じょうきゅうしゃ (người có đăng cấp cao - [THƯỢNG CẤP GIẢ] - 例えば： じょうきゅうしゃ)
締切	しめきり ( hạn cuối, deadline - [ĐẾ THIẾT] - 例えば： しめきり)
有効	ゆうこう ( có hiệu quả, (IT) valid, enable - [HỮU HIỆU] - 例えば： ゆうこう)
継続	けいぞく (Sự tiếp tục, liên tục - [KẾ TỤC] - 例えば： けいぞく)
辛い	つらい (Đau đớn, đau khổ, hà khắc - [TÂN] - 例えば： つらい)
従う	したがう (Theo, căn cứ vào. - [TÔNG, TÙNG] - 例えば： したがう)
枯れる	かれる (Héo, héo úa, héo tàn - [KHÔ] - 例えば： かれる)
別れる	わかれる (Chia tay, ly biệt - [BIỆT] - 例えば： わかれる)
新型	しんがた (Kiểu mới, dạng mới, mô hình mới - [TÂN HÌNH] - 例えば： しんがた)
常識	じょうしき (Thông thường, thường thức - [THƯỜNG THỨC] - 例えば： じょうしき)
通用	つうよう (Được áp dụng, lưu thông, lưu hành - [THÔNG DỤNG] - 例えば： つうよう)
点検	てんけん (Kiểm điểm, kiểm tra - [ĐiỂM KIỂM] - 例えば： てんけん)
定期的	ていきてき (Chu kỳ, định kỳ - [ĐỊNH KỲ ĐÍCH] - 例えば： ていきてき)
排気ガス	はいきガス (Khí độc, khí thải - [BÀI KHÍ] - 例えば： はいきガス)
防止	ぼうし (Đề phòng, ngăn ngừa - [PHÒNG CHỈ] - 例えば： ぼうし)
連続	れんぞく (Liên tiếp, liên tục - [LIÊN TỤC] - 例えば： れんぞく)
フリーター	(Freelance, Người làm tự do, làm bán thời gian)
バイト	(Làm thêm, việc làm không chính thức)
ギャラ	(Cát xê, tiền thù lao, tiền trả cho diễn viên)
しっかり	(Chắc chắn, ổn định)
新鮮	しんせん (Tươi, mới - [TÂN TIÊN] - 例えば： しんせん)
まわり	(Sự quay)
負担	ふたん (Sự gánh vác, đảm nhận - [PHỤ ĐẢM] - 例えば： ふたん)
資金	しきん (Tiền vốn - [TƯ KIM] - 例えば： しきん)
気力	きりょく (Sinh lực, sức lực - [KHÍ LỤC] - 例えば： きりょく)
乗り越える	のりこえる (Trèo lên, vượt lên - [THỪA VIỆT] - 例えば： のりこえる)
根性	こんじょう (Bản tính, sự can đảm - [CĂN TÍNH] - 例えば： こんじょう)
ごちそう	(Chiêu đãi, khao)
農村	のうそん (Nông thôn - [NÔNG THÔN] - 例えば： のうそん)
過疎	かそ (Sự giảm dân số - [QUÁ SƠ] - 例えば： かそ)
外食	がいしょく (Đi ăn ngoài, đi ăn tiệm - [NGOẠI THỰC] - 例えば： がいしょく)
野菜	やさい (Rau - [DÃ THÁI] - 例えば： やさい )
調節	ちょうせつ (Điều tiết, điều chỉnh - [ĐiỀU, ĐiỆU TIẾT] - 例えば： ちょうせつ)
暖まる	あたたまる (Ấm lên - [NÕAN] - 例えば： あたたまる)
演技	えんぎ (Kỹ thuật trình diễn - [DIỄN KỸ] - 例えば： えんぎ)
加減	かげん (Sự giảm, sự điều chỉnh - [GIA GIẢM] - 例えば： かげん)
病状	びょうじょう (Bệnh tình, chứng bệnh - [BỆNH TRẠNG] - 例えば： びょうじょう)
治療	ちりょう (Điều trị - [TRỊ LiỆU] - 例えば： ちりょう )
提出	ていしゅつ (Nộp bài - [ĐỀ XUẤT] - 例えば： ていしゅつ)
完壁	かんべき (Hoàn thiện, toàn vẹn - [HÒAN BÍCH] - 例えば： かんべき)
迷子	まいご (Đứa trẻ bị lạc - [MÊ TỬ, TÝ] - 例えば： まいご)
畳	たたみ (Chiếu - [ĐiỆP] - 例えば： たたみ)
ニュアンス	(Sắc thái)
おまけ	(Giảm giá)
一歩	いっぽ (Một bước - [NHẤT BỘ] - 例えば： いっぽ)
しかる	(Quở trách; trách mắng)
郵便物	ゆうびんぶつ (Bưu phẩm - [BƯU TIỆN VẬT] - 例えば： ゆうびんぶつ)
乗り越す	のりこす (Đi vượt qua - [THỪA, THẶNG VIỆT])
プライベート	(Riêng tư; cá nhân)
誤解	ごかい (Hiểu lầm - [NGỘ(TẠ) GIẢI])
継ぐ	つぐ (Thừa kế; thừa hưởng; kế thừa - [KẾ])
意外	いがい (Ngoài dự tính; ngoài dự kiến (ngạc nhiên) - [Ý NGOẠI])
反抗	はんこう (Sự phản kháng - [PHẢN KHÁNG] - 例えば： はんこう)
兄妹	きょうだい (Huynh muội, Anh trai em gái - [HUYNH MUỘI] - 例えば： きょうだい)
武力	ぶりょく (Vũ lực - [VÕ, VŨ LỰC] - 例えば： ぶりょく)
指紋	しもん (Vân tay ,dấu tay - [CHỈ(SÁP, THÁP) VĂN] - 例えば： しもん)
好調	こうちょう (Trạng thái tốt; tình hình tiến triển tốt - [HẢO, HIẾU ĐiỀU, ĐiỆU] - 例えば： こうちょう)
機器	きき (Máy móc ,dụng cụ - [CƠ KHÍ] - 例えば： きき)
家電	かでん (Đồ điện tử gia dụng - [GIA ĐiỆN] - 例えば： かでん)
滞在	たいざい (Sự lưu lại ,tạm trú - [TRỆ TẠI] - 例えば： たいざい)
省略	しょうりゃく (sự lược bỏ, giản lượt - [TỈNH LƯỢC] - 例えば： しょうりゃく)
赤札	あかふだ (biển đỏ, phiếu giảm giá, biển giảm giá - [XÍCH TRÁT] - 例えば： あかふだ)
問い合わせ	といあわせ (hỏi , điều tra - [VẤN HỢP] - 例えば： といあわせ)
警察	けいさつ (cảnh sát, thám tử - [CẢNH SÁT] - 例えば： けいさつ)
実態	じったい (tình hình thực tế, tình trạng thực tế - [THỰC THÁI] - 例えば： じったい)
利益	りえき (Lợi ích, lợi nhuận - [LỢI ÍCH] - 例えば： りえき)
最優先	さいゆうせん (Ưu tiên cao nhất - [TỐI ƯU TIÊN] - 例えば： さいゆうせん)
観客	かんきゃく (Khán giả - [QUAN KHÁCH] - 例えば： かんきゃく)
投げる	なげる (ném - [ĐẦU] - 例えば： なげる)
苦戦	くせん (Chiến đấu gian khổ, khỏ chiến, lâm vào tình trạng khó khăn - [KHỔ CHIẾN] - 例えば： くせん)
日当たり	ひあたり (hướng nắng - [NHẬT ĐANG, ĐƯƠNG] - 例えば： ひあたり)
後援	こうえん (Bảo trợ, hậu thuẫn - [HẬU VIỆN, VIÊN] - 例えば： こうえん)
受け身文	うけみぶん (Câu bị động - [THỤ THÂN VĂN] - 例えば： うけみぶん)
展示	てんじ (Sự trưng bày - [TRIỂN THỊ] - 例えば： てんじ)
エネルギー	(Năng lượng)
消費量	しょうひりょう (Lượng tiêu xài, Số tiền dùng vào việc gì đó - [TIÊU PHÍ LƯỢNG] - 例えば： しょうひりょう)
距離	きょり (Khoảng cách, cự li - [CỰ LY] - 例えば： きょり)
値下げ	ねさげ (Sự giảm giá, Sự bớt giá - [TRỊ HẠ] - 例えば： ねさげ)
不順に	ふじゅんに (không thuận lợi , không tiến triển tốt... - [BẤT THUẬN] - 例えば： ふじゅんに)
トラブル	(Rắc rối)
国籍	こくせき (Quốc tịch - [QUỐC TỊCH] - 例えば： こくせき)
眠れなく	ねむれなく (Mất ngủ, Không ngủ được - [MIÊN] - 例えば： ねむれなく)
合否	ごうひ (Thành công hay thất bại, đâu hay rớt - [HỢP PHỦ] - 例えば： ごうひ)
朝方	あさがた (Cho đến sáng, tới sáng - [TRIỀU PHƯƠNG] - 例えば： あさがた)
積もる	つもる (Chất; chất đống - [TÍCH] - 例えば： つもる)
流行る	はやる (Lưu hành; thịnh hành - [LƯU HÀNH, HÀNG, HẠNH] - 例えば： はやる)
渡る	わたる (Băng qua; đi qua - [ĐỘ] - 例えば： わたる)
長年	ながねん (Nhiều năm - [TRƯỜNG, TRƯỞNG NIÊN] - 例えば： ながねん)
理性	りせい (Lý tính; lý trí - [LÝ TÍNH] - 例えば： りせい)
新たな	あらたな (Sự tươi; sự mới - [TÂN] - 例えば： あらたな)
多方面	たほうめん (Nhiều mặt, nhiều phía , đa phương diện - [ĐA PHƯƠNG DIỆN] - 例えば： たほうめん)
表	おもて (Biểu; bảng; bảng biểu - [BIỂU] - 例えば： おもて)
サイト	(Site)
パスワード	(Mật khẩu, mật lệnh (password))
水道	すいどう (Nước dịch vụ; nước máy - [THỦY ĐẠO] - 例えば： すいどう)
断水	だんすい (Sự cắt nước; sự không cung cấp nước - [ĐÓAN THỦY] - 例えば： だんすい)
作家	さっか (Tác giả; tác gia; cây bút - [TÁC GIA] - 例えば： さっか)
先立つ	さきだつ (Đi trước; đứng trước; đặt trước; ở trước - [TIÊN LẬP] - 例えば： さきだつ)
マスコミ	(Giới báo chí; phương tiện truyền thông đại chúng)
撮影	さつえい (Sự chụp ảnh - [TÓAT ẢNH] - 例えば： さつえい)
許可	きょか (Sự cho phép; sự phê duyệt; sự chấp nhận - [HỨA KHẢ] - 例えば： きょか)
建設	けんせつ (Sự kiến thiết; sự xây dựng - [KIẾN THIẾT] - 例えば： けんせつ)
住民	じゅうみん (cư dân - [TRÚ DÂN] - 例えば： じゅうみん)
被害者	ひがいしゃ (Nạn nhân; người bị hại - [BỊ HẠI GIẢ] - 例えば： ひがいしゃ)
氏名	しめい (Họ tên - [THỊ, CHI DANH])
公表	こうひょう (Sự công bố; sự tuyên bố - [CÔNG BIỂU])
プライバシー	(sự riêng tư; cá nhân)
配慮	はいりょ (sự xem xét, sự cân nhắc - [PHỐI LỰ])
飲食	いんしょく (Ăn uống; - [Ẩm THỰC])
禁止	きんし (Sự cấm; sự cấm đoán; nghiêm cấm - [CẤM CHỈ])
禁煙	きんえん (Cấm hút thuốc - [CẤM YÊN])
プラス	(Sự thêm vào; cộng; dương (plus) )
加える	くわえる (Thêm vào; gia tăng - [GIA])
通話	つうわ (Sự gọi điện thoại - [THÔNG THOẠI])
通常	つうじょう (Thông thường; thường thường - [THÔNG THƯỜNG])
ポイント	(Điểm; điểm số (point))
セール	(Sự bán hàng; sự bán ra; sự giảm giá)
交代	こうたい (Thay thế, thay phiên - [GIAO ĐẠI])
代行	だいこう (Làm thay - [ĐẠI HÀNH, HÀNG, HẠNH])
広告	こうこく (Quảng cáo - [QUẢNG CÁO])
応える	こたえる (Trả lời, đáp ứng, nhận lời - [ỨNG])
和菓子	わがし (Bánh kẹo Nhật - [HÒA, HỌA QUẢ TỬ, TÝ])
信頼	しんらい (Sự tin cậy, tín nhiệm - [TÍN LẠI])
一同	いちどう (Đồng loạt, nhất thể - [NHẤT ĐỒNG])
伸ばす	のばす (Mở rộng, phát triển - [THÂN])
伴う	ともなう (Cùng với, theo cùng, - [BẠN])
高齢者	こうれいしゃ (Người lớn tuổi - [CAO LINH GIẢ])
矢印	やじるし (Mũi tên - [THỈ ẤN])
採点	さいてん (Chấm điểm - [THẢI ĐiỂM])
兼ねる	かねる (kiêm nhiệm, kèm theo - [KIÊM])
出版	しゅっぱん (Xuất bản - [XUẤT BẢN])
職人	しょくにん (Người lao động, người thợ - [CHỨC NHÂN])
一つ一つ	ひとつひとつ (Từng cái một - [NHẤT NHẤT])
媒介	ばいかい (Môi giới, trung gian - [MÔI GIỚI])
当社	とうしゃ (Công ty tôi đang làm - [ĐANG, ĐƯƠNG XÃ])
貢献する	こうけんする (Cống hiến, đóng góp - [CỐNG HIẾN])
一生	いっしょう (Cả đời, suốt đời, một đời - [NHẤT SINH])
巡る	めぐる (Đi dạo, dạo quanh - [TUẦN])
死後	しご (Sau khi chết, sau cái chết - [TỬ HẬU])
仲が悪い	なかがわるい (Quan hệ không tốt, không thân thiện - [TRỌNG ÁC])
墓	はか (Mồ, mã, huyệt, mộ - [MỘ])
記念碑	きねんひ (Bia tưởng niệm, bia kỷ niệm - [KÝ NiỆM BI])
四季	しき (4 mùa - [TỨ QÚI])
訴える	うったえる (Kiện cáo, tố tụng - [TỐ])
怒り	いかり (Giận dữ, tức giận - [NỘ])
サークル	(Circle, đường tròn, hình tròn)
契機	けいき (cơ hội, động cơ - [KHẾ CƠ])
基礎	きそ ( cơ sở, nền tảng - [CƠ SỞ])
知識	ちしき ( kiến thức - [TRI, TRÍ THỨC])
改善	かいぜん ( cải tiến, cải thiện - [CẢI THIỆN])
空手	からて (Võ karate - [KHÔNG THỦ])
強化	きょうか ( tăng cường, đẩy mạnh - [CƯỜNG, CƯỠNG(MiỄN) HÓA])
定年	ていねん (Về hưu - [ĐỊNH NIÊN])
故郷	ふるさと ( quê nhà, cố hương - [CỐ HƯƠNG])
中高年	ちゅうこうねん ( tuổi trung - cao niên - [TRUNG, TRÚNG CAO NIÊN])
高速道路	こうそくどうろ ( đường cao tốc - [CAO TỐC ĐẠO LỘ])
金融	きんゆう (Ngân hàng, tín dụng - [KIM DUNG])
鉄鋼	てっこう (sắt thép,gang thép - [THIẾT CƯƠNG])
経済誌	けいざいし ( tạp chí kinh tế - [KINH TẾ CHÍ])
激減	げきげん ( giảm đi nhanh chóng - [KÍCH, KHÍCH GIẢM])
交換	こうかん (Chuyển đổi - [GIAO HOÁN])
壁	かべ (Bức tường - [BÍCH])
落書き	らくがき (Sự viết nghệch ngoặc, viết ngoáy - [LẠC THƯ])
完璧	かんぺき (Hoàn mỹ, toàn diện - [HOÀN BÍCH])
非婚	ひこん (Không kết hôn - [PHI HÔN])
共働き	ともばたらき (Việc cùng đi làm kiếm sống - [CỘNG ĐỌNG])
雇用	こよう (sự thuê mướn - [CỐ DỤNG])
均等法	きんとうほう (luật bình đẳng - [QUÂN ĐẲNG LUẬT])
上達	じょうたつ (Sự tiến bộ - [THƯỢNG ĐẠT])
描く	かく (tả, vẽ - [MIÊU])
優秀	ゆうしゅう (sự ưu tú - [ƯU TÚ])
カメ	(con rùa)
堅苦しい	かたくるしい (câu nệ hình thức, nghiêm túc, trang trọng - [KIÊN KHỔ])
早速	さっそく (ngay lập tức - [TẢO TỐC])
診察券	しんさつけん (Phiếu đăng kí khám bệnh - [CHẨN SÁT KHÓAN])
看護士	かんごし (Y tá - [KHÁN HỘ SĨ])
求む	もとむ (Tìm kiếm, yêu cầu, mong muốn - [CẦU])
勇気	ゆうき (Can đảm, cứng rắn, dũng khí - [DŨNG KHÍ])
免許	めんきょ (Sự cho phép, giấy phép, bằng cấp - [HỨA])
家具	かぐ (Đồ trang trí nội thất, đồ đạc trong nhà - [GIA CỤ])
豊富	ほうふ (Giàu có, phong phú - [PHONG PHÚ])
言葉遣い	ことばづかい (Cách sử dụng từ ngữ, cách dùng từ, lời ăn tiếng nói - [NGÔN DIỆP KHIỂN. KHIẾN])
料金	りょうきん (Tiền thù lao, tiền thưởng - [LIỆU KIM])
東西	とうざい (Đông tây - [ĐÔNG TÂY])
接する	せっする (Liên kết, tiếp nhận, giao tiếp - [TIẾP])
好む	このむ (Thích; thích hơn; yêu thích - [HẢO, HIẾU])
踏む	ふむ (Dẫm lên; trải qua - [ĐẠP])
来日	らいにち (ngày hôm sau - [LAI NHẬT])
甘口	あまくち (khéo nói, lời nịnh hót; lời ngon ngọt - [CAM KHẨU])
インテリア	(Nội thất; nội địa; nội bộ)
番組	ばんぐみ (Chương trình tivi; kênh - [PHIÊN TỔ])
近寄る	ちかよる (Tiếp cận; giao du - [CÂ?N KÝ])
貿易	ぼうえき (Thương mại; ngoại thương; giao dịch - [MẬU DỊ, DỊCH])
黒字	くろじ (Lãi; thặng dư - [HẮC TỰ])
他国	たこく (Quốc gia khác; nước khác - [THA QUỐC])
批判	ひはん (Phê phán; phê bình - [PHÊ PHÁN])
避ける	さける (Tránh; trốn tránh; lảng tránh - [TỴ])
新鮮な	しんせんな (Tươi; mới - [TÂN TIÊN])
温かい	あたたかい (Ấm; ấm áp; nóng - [ÔN])
ペンキ	(Sơn (paint))
塗る	ぬる (Quét sơn; thoa; bôi; xoa - [ĐỒ])
ベンチ	(Ghế dài; ghế ngồi (ở công viên))
炊く	たく (Đun sôi; nấu sôi; nấu - [XUY])
揚げる	あげる (Rán; chiên - [DƯƠNG])
産む	うむ (Sinh; đẻ - [SẢN])
スプレー	(Bình phun; bơm phun (spray))
容器	ようき (Đồ đựng, đồ chứa - [DUNG KHÍ])
中身	なかみ (Bên trong; nội dung - [TRUNG, TRÚNG THÂN])
一晩	ひとばん (Một đêm; cả đêm; trọn đêm - [NHẤT VÃN])
逃げる	にげる (Chạy; trốn chạy; thoát khỏi - [ĐÀO])
困難	こんなん (Khó khăn; vất vả - [KHỐN NẠN])
餌	えさ (Mồi; đồ ăn cho động vật; thức ăn gia súc gia cầm)
野生	やせい (hoang dã; dã sinh - [DÃ SINH])
だらしない	(Bừa bộn; bừa bãi; lôi thôi)
悲しい	かなしい (Buồn; buồn bã - [BI])
寂しい	さびしい (Buồn; cô đơn; cô quạnh - [TỊCH])
懐かしい	なつかしい (Nhớ tiếc, hồi tưởng - [HÒAI])
怪しい	あやしい (Đáng ngờ; khó tin - [QUÁI])
隠れる	かくれる (Trốn; ẩn nấp - [ẨN])
詫び	わび (Sự xin lỗi)
定刻	ていこく (thời khắc đã định - [ĐỊNH KHẮC])
到着	とうちゃく (Sự đến; sự đến nơi - [ĐÁO TRƯỚC])
団体	だんたい (Đoàn thể; tập thể - [ĐÒAN THỂ])
編む	あむ (Đan; bện - [BIÊN])
セーター	(Áo len chui đầu; áo len dài tay)
焦る	あせる (Sốt ruột; vội vàng; hấp tấp - [TIÊU])
ジャケット	(Áo khoác; áo jac-ket)
品	しな (Đồ vật; hàng hóa - [PHẨM])
歯磨き粉	はみがきこ (Kem đánh răng - [XỈ MA PHẤN])
皺	しわ (Nếp nhăn; nếp gấp)
見っともない	みっともない (Đáng xấu hổ; khó coi; mất thể diện - [KIẾN])
アイロンかける	(Ủi đồ)
評判	ひょうばん (Sự bình luận; lời bình luận - [BÌNH PHÁN])
興味	きょうみ (Hứng thú - [HỨNG, HƯNG VỊ])
飽きる	あきる (Chán ghét; mệt mỏi; không còn hứnng thú - [BÃO])
体調	たいちょう ( tình trạng sức khỏe - [THỂ ĐiỀU, ĐiỆU])
行動	こうどう (Hành động; sự hành động - [HÀNH, HÀNG, HẠNH ĐỘNG])
許す	ゆるす (Tha lỗi; tha thứ; cho phép - [HỨA])
届く	とどく (Đạt được - [GIỚI])
やはり	(Đương nhiên; rõ ràng - [THỈ TRƯƠNG])
無事	ぶじ (Bình an; vô sự - [VÔ SỰ])
冷暖房	れいだんぼう (Máy lạnh - [LÃNH NÕAN PHÒNG])
調整	ちょうせい (Điều chỉnh - [ĐiỀU, ĐiỆU CHỈNH])